JUD_DIST,COUNTY,STATE,FIPS,LONGITUDE,LATITUDE,POP1990,POP90_SQMI,HOUSEHOLDS,MALES,FEMALES,WHITE,BLACK,AMERI_ES,ASIAN_PI,OTHER,HISPANIC,AGE_UNDER5,AGE_5_17,AGE_18_64,AGE_65_UP,HSE_UNITS,VACANT,OWNER_OCC,RENTER_OCC,MEDIAN_VAL,MEDIANRENT
AK D,Aleutians East,Alaska,2013,-161.8740006,55.6420784,2464,0.35,533,1582,882,827,16,1042,463,116,180,181,366,1859,58,693,160,327,206,85700,518
AK D,Aleutians West,Alaska,2016,-166.7737015,53.62332535,9478,2.15,1845,6238,3240,6360,662,1076,979,401,742,779,1104,7513,82,2051,206,330,1515,80100,428
AK D,Anchorage,Alaska,2020,-149.2609787,61.11357498,226338,130.68,82702,116367,109971,182736,14544,14569,10910,3579,9258,21499,45189,151392,8258,94153,11451,43672,39030,109700,528
AK D,Bethel,Alaska,2050,-163.0226746,60.44192696,13656,0.38,3605,7155,6501,2105,62,11370,91,28,80,1865,3467,7667,657,4362,757,2118,1487,51900,460
AK D,Bristol Bay,Alaska,2060,-156.7888794,58.75788498,1410,2.66,407,845,565,894,38,455,12,11,33,123,259,986,42,596,189,198,209,102000,464
AK D,Dillingham,Alaska,2070,-158.6622009,59.70124435,4012,0.22,1215,2076,1936,1019,8,2925,27,33,49,560,944,2303,205,1691,476,768,447,63300,518
AK D,Fairbanks North Star,Alaska,2090,-146.2748413,64.85444641,77720,10.5,26693,41506,36214,63751,5553,5330,1998,1088,2899,8086,16251,50843,2540,31823,5130,13091,13602,87300,471
AK D,Haines,Alaska,2100,-135.4092865,58.98894691,2117,0.89,791,1130,987,1802,1,279,17,18,27,155,437,1343,182,1112,321,514,277,81000,405
AK D,Juneau,Alaska,2110,-134.1646423,58.38117027,26751,10.19,9902,13575,13176,21570,292,3462,1154,273,749,2410,5440,17537,1364,10638,736,5764,4138,113500,587
AK D,Kenai Peninsula,Alaska,2122,-152.8581009,60.06590271,40802,2.54,14250,21606,19196,37089,203,2935,428,147,726,3795,9601,25391,2015,19364,5114,9677,4573,85100,410
AK D,Ketchikan Gateway,Alaska,2130,-131.4002686,55.54430008,13828,11.13,5030,7217,6611,11316,55,1898,493,66,285,1211,2911,8799,907,5463,433,2819,2211,112600,533
AK D,Kodiak Island,Alaska,2150,-155.0099335,58.02614021,13309,2.78,4083,7395,5914,9289,135,2126,1492,267,663,1403,2728,8753,425,4885,802,2043,2040,111500,602
AK D,Lake and Peninsula,Alaska,2164,-156.6463928,58.28878212,1668,0.07,509,911,757,389,0,1261,12,6,32,213,421,949,85,991,482,354,155,67100,417
AK D,Matanuska-Susitna,Alaska,2170,-149.7134018,62.3296299,39683,1.62,13394,20605,19078,36949,307,1939,297,191,752,3873,10140,23804,1866,20953,7559,9821,3573,71500,430
AK D,Nome,Alaska,2180,-165.6171036,64.76674652,8288,0.35,2371,4480,3808,2023,9,6148,55,53,106,1073,2102,4694,419,3684,1313,1347,1024,56700,546
AK D,North Slope,Alaska,2185,-153.9149094,69.70281219,5979,0.07,1673,3258,2721,1274,41,4336,285,43,124,830,1408,3544,197,2153,480,670,1003,80700,600
AK D,Northwest Arctic,Alaska,2188,-159.7144165,66.8572464,6113,0.17,1526,3224,2889,841,12,5209,48,3,36,960,1672,3200,281,1998,472,884,642,62800,627
AK D,Prince of Wales-Outer Ketchikan,Alaska,2201,-130.5145964,55.58362961,6278,0.82,2061,3545,2733,3859,9,2358,28,24,121,585,1443,4034,216,2543,482,1247,814,63300,329
AK D,Sitka,Alaska,2220,-135.144455,56.84790802,8588,2.92,2939,4504,4084,6359,39,1797,333,60,209,764,1871,5461,492,3222,283,1644,1295,120000,520
AK D,Skagway-Yakutat-Angoon,Alaska,2231,-136.6809616,58.68082809,4385,0.33,1422,2420,1965,2649,7,1670,32,27,67,392,1042,2716,235,2102,680,771,651,65200,306
AK D,Southeast Fairbanks,Alaska,2240,-144.350235,63.8672905,5913,0.24,1909,3187,2726,4670,290,770,82,101,177,601,1507,3582,223,3149,1240,1161,748,54900,389
AK D,Valdez-Cordova,Alaska,2261,-144.869606,61.49766922,9952,0.25,3425,5471,4481,8247,57,1245,324,79,270,881,2023,6585,463,5196,1771,2210,1215,97100,457
AK D,Wade Hampton,Alaska,2270,-163.199028,62.09849739,5791,0.33,1368,3007,2784,346,12,5405,23,5,17,1040,1614,2879,258,1882,514,929,439,42400,359
AK D,Wrangell-Petersburg,Alaska,2280,-132.2631683,56.53291893,7042,1.18,2514,3776,3266,5544,11,1367,94,26,119,688,1484,4363,507,3005,491,1676,838,91700,422
AK D,Yukon-Koyukuk,Alaska,2290,-151.022644,65.20294952,8478,0.05,2748,4787,3691,3584,88,4726,51,29,82,930,2023,5133,392,4899,2151,1954,794,31800,279
AL MD,Autauga,Alabama,1001,-86.65922546,32.51647377,34222,57.32,11826,16653,17569,27144,6845,71,120,42,230,2679,7419,20752,3372,12732,906,9422,2404,59200,257
AL MD,Barbour,Alabama,1005,-85.40007782,31.89025116,25417,28.75,9218,12085,13332,14118,11194,46,44,15,124,1885,5579,14227,3726,10705,1487,6490,2728,41400,146
AL MD,Bullock,Alabama,1011,-85.70585251,32.09552097,11042,17.67,3787,5335,5707,3036,7986,8,10,2,65,948,2433,5888,1773,4458,671,2729,1058,32300,102
AL MD,Butler,Alabama,1013,-86.67892456,31.74985123,21892,28.1,7935,10239,11653,13049,8798,24,19,2,65,1639,4952,11621,3680,8745,810,5788,2147,34000,133
AL MD,Chambers,Alabama,1017,-85.35988617,32.92561722,36876,61.87,13786,17385,19491,23575,13221,41,13,26,127,2418,7214,21025,6219,14910,1124,10472,3314,37900,154
AL MD,Chilton,Alabama,1021,-86.69530487,32.87237358,32458,46.7,12114,15767,16691,28647,3674,63,38,36,116,2199,6488,19266,4505,13883,1769,9838,2276,42800,157
AL MD,Coffee,Alabama,1031,-85.99224472,31.41459465,40240,59.18,15260,19662,20578,32702,6917,163,317,141,471,2694,7633,24603,5310,16951,1691,10813,4447,53300,234
AL MD,Coosa,Alabama,1037,-86.26520538,32.93272209,11063,16.84,4017,5431,5632,7242,3782,34,4,1,18,790,2092,6579,1602,5113,1096,3321,696,35600,137
AL MD,Covington,Alabama,1039,-86.44310379,31.26459312,36478,35.14,14444,17245,19233,31551,4777,72,48,30,130,2320,6917,20940,6301,16178,1734,10935,3509,34800,147
AL MD,Crenshaw,Alabama,1041,-86.32109451,31.75429344,13635,22.32,5262,6468,7167,10048,3544,27,11,5,30,896,2748,7495,2496,5938,676,3928,1334,31200,118
AL MD,Dale,Alabama,1045,-85.60606766,31.41488552,49633,88.47,17574,25057,24576,39365,8847,239,731,451,1215,4283,9593,31098,4659,19432,1858,10723,6851,49400,238
AL MD,Elmore,Alabama,1051,-86.14113235,32.59268188,49210,79.12,16532,24899,24311,37850,11039,137,129,55,270,3327,9465,30676,5742,19497,2965,13282,3250,58100,197
AL MD,Geneva,Alabama,1061,-85.83421326,31.09947205,23647,40.91,9231,11388,12259,20682,2824,93,15,33,121,1516,4374,13793,3964,10416,1185,7214,2017,35800,130
AL MD,Henry,Alabama,1067,-85.22980118,31.5579052,15374,27.6,5769,7271,8103,9918,5395,31,6,24,92,1008,3093,8773,2500,7056,1287,4524,1245,41300,134
AL MD,Houston,Alabama,1069,-85.35477448,31.16707897,81331,140.95,30844,38632,42699,61513,18954,287,470,107,464,5985,16488,48730,10128,33196,2352,20836,10008,52600,215
AL MD,Lee,Alabama,1081,-85.34637451,32.58142853,87146,143.1,33097,43215,43931,64889,20407,132,1584,134,552,5409,13679,60607,7451,36636,3539,19238,13859,64900,266
AL MD,Lowndes,Alabama,1085,-86.65592575,32.18954754,12658,17.73,4056,5865,6793,3185,9456,10,4,3,60,1142,3253,6658,1605,4792,736,3266,790,34800,99
AL MD,Macon,Alabama,1087,-85.72472382,32.41970062,24928,40.6,8483,11547,13381,3443,21340,24,99,22,103,1794,4848,14459,3827,9818,1335,5679,2804,43400,186
AL MD,Montgomery,Alabama,1101,-86.21489334,32.24129105,209085,263.66,77173,98558,110527,119420,87312,414,1533,406,1624,16119,41265,127427,24274,84525,7352,48070,29103,62600,292
AL MD,Pike,Alabama,1109,-85.93196487,31.84678841,27595,41.06,10314,12930,14665,17814,9548,146,68,19,108,1843,5023,16697,4032,11506,1192,6851,3463,43500,177
AL MD,Randolph,Alabama,1111,-85.44208527,33.31079102,19881,34.04,7553,9620,10261,15138,4686,29,21,7,53,1272,3913,11405,3291,8728,1175,5964,1589,36500,133
AL MD,Russell,Alabama,1113,-85.16362762,32.29413795,46860,73.91,17499,22392,24468,28473,18088,90,117,92,301,3536,8944,28439,5941,19633,2134,11380,6119,46200,195
AL MD,Tallapoosa,Alabama,1123,-85.79769897,32.80904198,38826,55.39,14700,18262,20564,28493,10212,62,37,22,71,2493,7434,22646,6253,17312,2612,11045,3655,43200,160
AL ND,Bibb,Alabama,1007,-87.15131378,33.04232788,16576,26.52,5745,8107,8469,13052,3478,25,11,10,39,1171,3622,9682,2101,6404,659,4510,1235,39500,140
AL ND,Blount,Alabama,1009,-86.63572693,34.01463318,39248,61.04,14644,19159,20089,38397,521,133,33,164,286,2648,7388,24096,5116,15790,1146,11972,2672,46500,164
AL ND,Calhoun,Alabama,1015,-85.83333206,33.76612473,116034,189.91,42983,56058,59976,92873,21578,296,869,418,1282,7379,21599,72679,14377,46753,3770,30222,12761,51600,218
AL ND,Cherokee,Alabama,1019,-85.61962128,34.23079681,19543,35.34,7466,9607,9936,18154,1291,51,24,23,57,1132,3560,11961,2890,9379,1913,5959,1507,44700,148
AL ND,Clay,Alabama,1027,-85.90863419,33.2972393,13252,21.9,5003,6363,6889,11044,2166,23,13,6,27,788,2530,7702,2232,5608,605,3781,1222,35500,116
AL ND,Cleburne,Alabama,1029,-85.59691238,33.71524429,12730,22.69,4776,6253,6477,12084,587,20,13,26,38,854,2458,7713,1705,5232,456,3901,875,42600,147
AL ND,Colbert,Alabama,1033,-87.77682877,34.73780441,51666,87.72,20096,24801,26865,42820,8568,137,93,48,187,3406,9142,31530,7588,21812,1716,15131,4965,46300,191
AL ND,Cullman,Alabama,1043,-86.77959442,34.08805656,67613,91.62,25605,32851,34762,66744,560,134,117,58,272,4463,12549,40827,9774,28369,2764,19913,5692,48100,184
AL ND,De Kalb,Alabama,1049,-85.82157898,34.53392029,54651,70.25,20968,26377,28274,52980,1028,481,77,85,215,3362,10545,32736,8008,22939,1971,16393,4575,39700,161
AL ND,Etowah,Alabama,1055,-86.05297089,34.03019142,99840,184.21,38675,47261,52579,85274,13799,250,419,98,331,5973,18616,59375,15876,41787,3112,28612,10063,42700,186
AL ND,Fayette,Alabama,1057,-87.68404007,33.72577667,17962,28.51,6859,8568,9394,15717,2190,9,19,27,78,1099,3503,10430,2930,7555,696,5265,1594,36800,132
AL ND,Franklin,Alabama,1059,-87.84900284,34.44651031,27814,43.26,10850,13294,14520,26463,1249,57,35,10,101,1795,5109,16607,4303,11772,922,8146,2704,38300,146
AL ND,Greene,Alabama,1063,-87.95841599,32.84156036,10153,16.09,3512,4660,5493,1966,8181,3,0,3,24,787,2555,5221,1590,4162,650,2497,1015,35800,99
AL ND,Jackson,Alabama,1071,-85.96696854,34.73719788,47796,44.67,18020,23071,24725,44696,1968,1020,90,22,208,2986,9328,29482,6000,19768,1748,13827,4193,43200,169
AL ND,Jefferson,Alabama,1073,-86.9297905,33.54666519,651525,582.24,251479,304259,347266,418317,228521,889,3222,576,2745,44919,117669,397465,91472,273097,21618,164085,87394,58700,263
AL ND,Lamar,Alabama,1075,-88.108284,33.79506683,15715,25.98,6005,7509,8206,13805,1862,24,10,14,71,999,2991,9255,2470,6617,612,4539,1466,38900,110
AL ND,Lauderdale,Alabama,1077,-87.70124817,34.87793732,79661,120.52,30905,37975,41686,71560,7695,165,196,45,313,5096,13985,49206,11374,33522,2617,22673,8232,52700,217
AL ND,Lawrence,Alabama,1079,-87.316082,34.55606651,31513,45.47,11410,15502,16011,24563,4798,2124,19,9,102,2293,6346,19137,3737,12212,802,9222,2188,44300,143
AL ND,Limestone,Alabama,1083,-87.02379608,34.78373718,54135,96.84,19685,27077,27058,46658,7127,148,158,44,261,3691,9915,34408,6121,21455,1770,15003,4682,56300,214
AL ND,Madison,Alabama,1089,-86.51515579,34.7359581,238912,296.42,91208,117724,121188,184197,48116,1601,4232,766,2984,17462,41293,158767,21390,97855,6647,59387,31821,77900,332
AL ND,Marion,Alabama,1093,-87.91815567,34.1192627,29830,40.15,11521,14587,15243,28759,967,57,35,12,65,1887,5435,17970,4538,12597,1076,8671,2850,38300,132
AL ND,Marshall,Alabama,1095,-86.32059097,34.35592651,70832,124.92,27761,33905,36927,69361,1087,231,111,42,289,4583,12883,43415,9951,30225,2464,20587,7174,48100,200
AL ND,Morgan,Alabama,1103,-86.82819748,34.49772644,100043,173.99,37799,48675,51368,89122,10081,310,370,160,584,6911,19105,62329,11698,40419,2620,27157,10642,60900,261
AL ND,Pickens,Alabama,1107,-88.08677292,33.26302719,20699,23.26,7568,9660,11039,12002,8645,24,27,1,50,1463,4431,11411,3394,8379,811,5820,1748,38000,99
AL ND,Shelby,Alabama,1117,-86.68412781,33.29016876,99358,124.2,35985,48635,50723,90715,7718,264,575,86,525,7978,19213,64602,7565,39201,3216,27191,8794,88300,379
AL ND,St. Clair,Alabama,1115,-86.31337357,33.69346428,50009,77.41,17666,25115,24894,45138,4561,136,77,97,209,3602,9708,30901,5798,20382,2716,14674,2992,53400,199
AL ND,Sumter,Alabama,1119,-88.13126755,32.64888763,16174,17.83,5545,7469,8705,4759,11369,6,30,10,78,1228,3744,8848,2354,6545,1000,3935,1610,34700,115
AL ND,Talladega,Alabama,1121,-86.14599609,33.403759,74107,98.42,26448,35777,38330,50970,22773,174,113,77,490,5093,15400,44032,9582,29861,3413,19897,6551,44800,163
AL ND,Tuscaloosa,Alabama,1125,-87.4477272,33.31521225,150522,112.67,55354,72645,77877,109398,39377,253,1264,230,948,9647,26018,97778,17079,58740,3386,34023,21331,62100,254
AL ND,Walker,Alabama,1127,-87.29722214,33.7638073,67670,84.17,25554,32484,35186,63042,4405,84,107,32,224,4220,12890,40814,9746,28427,2873,20258,5296,42100,175
AL ND,Winston,Alabama,1133,-87.37408066,34.15380096,22053,35.98,8544,10757,11296,21925,57,42,26,3,59,1414,4018,13513,3108,10254,1710,6825,1719,37700,140
AL SD,Baldwin,Alabama,1003,-87.70687485,30.78024387,98280,61.85,37044,47741,50539,84565,12640,630,221,224,1022,6753,18780,57868,14879,50933,13889,29025,8019,64200,265
AL SD,Choctaw,Alabama,1023,-88.19960403,32.00864124,16018,17.62,5747,7593,8425,8913,7077,10,12,6,53,1136,3572,9091,2219,6789,1042,4873,874,37200,99
AL SD,Clarke,Alabama,1025,-87.83780289,31.59597397,27240,22.15,9506,13012,14228,15527,11625,45,35,8,103,1948,6207,15508,3577,10853,1347,7566,1940,40300,147
AL SD,Conecuh,Alabama,1035,-87.04311752,31.47360992,14054,16.46,5259,6639,7415,8063,5925,43,13,10,82,943,2975,7706,2430,6207,948,4213,1046,33300,110
AL SD,Dallas,Alabama,1047,-87.13888931,32.37869072,48130,49.36,17033,21937,26193,20121,27825,41,129,14,131,3870,11235,26412,6613,19045,2012,10588,6445,43800,151
AL SD,Escambia,Alabama,1053,-87.15860367,31.13461971,35518,37.35,12899,17477,18041,24326,10046,1047,58,41,169,2306,7161,21121,4930,14356,1457,9853,3046,41100,153
AL SD,Hale,Alabama,1065,-87.64442825,32.75116539,15498,23.45,5397,7235,8263,6255,9214,20,9,0,57,1233,3649,8145,2471,6370,973,4267,1130,34900,99
AL SD,Marengo,Alabama,1091,-87.79205322,32.27236366,23084,23.51,8156,10887,12197,11314,11745,11,11,3,75,1800,5193,12721,3370,9144,988,6288,1868,41800,117
AL SD,Mobile,Alabama,1097,-88.18212509,30.75436592,378643,305.85,136899,179577,199066,254853,117872,1940,3398,580,3164,29633,78400,225955,44655,151220,14321,91513,45386,53300,233
AL SD,Monroe,Alabama,1099,-87.34765625,31.53883553,23968,23.52,8412,11577,12391,14320,9372,215,54,7,94,1869,5509,13441,3149,9633,1221,6500,1912,43200,169
AL SD,Perry,Alabama,1105,-87.27022552,32.59322357,12759,17.77,4201,5940,6819,4503,8219,16,14,7,36,976,3026,6735,2022,4807,606,2946,1255,31600,99
AL SD,Washington,Alabama,1129,-88.17565155,31.41139221,16694,15.44,5709,8144,8550,10984,4623,1068,14,5,51,1229,3854,9601,2010,6625,916,4978,731,34300,112
AL SD,Wilcox,Alabama,1131,-87.26302338,32.05375862,13568,15.37,4415,6312,7256,4203,9353,6,6,0,40,1075,3537,6810,2146,5119,704,3403,1012,34000,99
AR ED,Arkansas,Arkansas,5001,-91.37221146,34.25244904,21653,21.52,8389,10230,11423,16816,4738,53,35,11,61,1474,4468,12087,3624,9575,1186,5620,2769,40600,179
AR ED,Chicot,Arkansas,5017,-91.24739075,33.28774834,15713,24.21,5557,7222,8491,6692,8859,22,57,83,159,1247,3839,8088,2539,6191,634,3846,1711,28700,140
AR ED,Clay,Arkansas,5021,-90.43114853,36.34484673,18107,28.25,7504,8652,9455,18031,6,45,14,11,70,1035,3138,10188,3746,8362,858,5550,1954,28900,149
AR ED,Cleburne,Arkansas,5023,-92.01659012,35.53909492,19411,35.23,7926,9406,10005,19292,6,72,22,19,105,1017,3201,11140,4053,10802,2876,6443,1483,50700,200
AR ED,Cleveland,Arkansas,5025,-92.20436478,33.89195442,7781,12.99,2868,3783,3998,6681,1059,13,14,14,47,502,1544,4573,1162,3322,454,2382,486,33900,129
AR ED,Conway,Arkansas,5029,-92.75771332,35.27127075,19151,34.32,7179,9179,9972,16139,2876,73,30,33,119,1333,3873,10807,3138,8009,830,5486,1693,38200,179
AR ED,Craighead,Arkansas,5031,-90.6607132,35.84867668,68956,96.71,26285,33169,35787,64449,3778,200,393,136,386,4824,12210,43565,8357,28434,2149,17194,9091,50200,261
AR ED,Crittenden,Arkansas,5035,-90.28246307,35.14187431,49939,83.37,17120,23566,26373,28152,21401,90,181,115,336,4409,11516,28729,5285,18875,1755,10437,6683,48900,228
AR ED,Cross,Arkansas,5037,-90.76911545,35.29744339,19225,30.91,6754,9222,10003,14343,4782,40,40,20,109,1447,4370,10733,2675,7254,500,4709,2045,39100,176
AR ED,Dallas,Arkansas,5039,-92.64564514,33.98143959,9614,14.39,3600,4602,5012,5873,3698,16,11,16,32,637,1917,5303,1757,4049,449,2803,797,33600,162
AR ED,Desha,Arkansas,5041,-91.20532608,33.82029724,16798,22.52,5957,7837,8961,9500,7139,48,37,74,152,1349,3975,8984,2490,6706,749,3934,2023,36700,144
AR ED,Drew,Arkansas,5043,-91.7221489,33.58968925,17369,20.9,6342,8350,9019,12530,4754,27,23,35,92,1214,3615,10194,2346,7159,817,4565,1777,38700,179
AR ED,Faulkner,Arkansas,5045,-92.35693741,35.11764336,60006,93.03,21325,29016,30990,54644,4778,256,226,102,341,4194,11151,38250,6411,23397,2072,15027,6298,55400,247
AR ED,Fulton,Arkansas,5049,-91.80228424,36.37321281,10037,16.29,4010,4802,5235,9969,10,47,9,2,28,582,1783,5548,2124,4839,829,3277,733,34000,152
AR ED,Grant,Arkansas,5053,-92.43624115,34.28139877,13948,22.03,5118,6860,7088,13491,377,38,21,21,82,950,2794,8421,1783,5540,422,4242,876,43000,200
AR ED,Greene,Arkansas,5055,-90.5089798,36.12207985,31804,54.93,12325,15380,16424,31627,20,79,41,37,167,2123,5892,18866,4923,13216,891,9000,3325,39400,199
AR ED,Independence,Arkansas,5063,-91.53578186,35.73292923,31192,40.88,11846,15171,16021,30344,595,80,115,58,172,2036,6157,18413,4586,12838,992,8915,2931,40600,186
AR ED,Izard,Arkansas,5065,-91.94078445,36.06476974,11364,19.56,4684,5460,5904,11266,11,64,18,5,71,634,1814,5976,2940,5535,851,3737,947,37300,146
AR ED,Jackson,Arkansas,5067,-91.30577469,35.62547112,18944,29.93,7361,9044,9900,16081,2759,66,23,15,66,1186,3678,10730,3350,8086,725,5047,2314,34100,151
AR ED,Jefferson,Arkansas,5069,-91.83023453,34.28112793,85487,96.92,30001,41107,44380,47878,36877,227,352,153,427,6239,17916,49819,11513,33311,3310,20121,9880,43300,218
AR ED,Lawrence,Arkansas,5075,-91.05434799,36.0725975,17457,29.64,6857,8375,9082,17223,88,126,16,4,60,1095,3205,9896,3261,7692,835,5147,1710,31000,165
AR ED,Lee,Arkansas,5077,-90.75153351,34.77525711,13053,21.68,4578,6155,6898,5449,7487,11,47,59,174,1068,3324,6612,2049,5085,507,2874,1704,31500,127
AR ED,Lincoln,Arkansas,5079,-91.68518066,33.98273659,13690,24.36,3796,8055,5635,8611,4935,65,20,59,152,822,2362,8855,1651,4295,499,2866,930,30300,120
AR ED,Lonoke,Arkansas,5085,-91.87657166,34.77900696,39268,50.15,13866,19297,19971,35395,3536,166,114,57,246,2754,8812,23142,4560,15009,1143,10319,3547,52700,217
AR ED,Mississippi,Arkansas,5093,-89.966362,35.70664406,57525,64.2,20420,27793,29732,40689,16006,168,352,310,745,5096,12906,32778,6745,22232,1812,11102,9318,41800,192
AR ED,Monroe,Arkansas,5095,-91.21341324,34.67465782,11333,18.61,4361,5317,6016,6862,4422,26,22,1,32,861,2480,5956,2036,5063,702,2751,1610,32300,133
AR ED,Perry,Arkansas,5105,-92.9178772,34.94272804,7969,14.49,3055,3919,4050,7780,119,42,17,11,47,497,1523,4657,1292,3702,647,2553,502,34800,158
AR ED,Phillips,Arkansas,5107,-90.81994247,34.38794327,28838,42.1,10183,13188,15650,12915,15753,40,72,58,237,2599,7270,14622,4347,11094,911,5470,4713,36900,135
AR ED,Poinsett,Arkansas,5111,-90.66281509,35.5763607,24664,32.37,9368,11872,12792,22797,1773,43,28,23,124,1778,4798,14315,3773,10271,903,6112,3256,34500,129
AR ED,Pope,Arkansas,5115,-93.04513168,35.42682076,45883,55.95,16828,22665,23218,44126,1129,319,200,109,423,3350,8727,28121,5685,18430,1602,11919,4909,48000,228
AR ED,Prairie,Arkansas,5117,-91.56863403,34.78808403,9518,14.51,3661,4670,4848,8170,1294,38,4,12,38,635,1828,5477,1578,4340,679,2679,982,35200,131
AR ED,Pulaski,Arkansas,5119,-92.38999557,34.75867081,349660,455.88,137209,166481,183179,252554,92200,1163,2762,981,3199,26386,65357,217689,40228,151538,14329,82772,54437,61300,303
AR ED,Randolph,Arkansas,5121,-91.08378983,36.31562233,16558,25.24,6445,8000,8558,16322,146,52,19,19,75,1080,3168,9461,2849,7343,898,4827,1618,31300,161
AR ED,Saline,Arkansas,5125,-92.6548996,34.63702393,64183,88.53,23037,31718,32465,62215,1348,285,245,90,378,4330,13198,39532,7123,24602,1565,18563,4474,59000,241
AR ED,Sharp,Arkansas,5135,-91.4889946,36.19246864,14109,23.28,5819,6708,7401,13908,66,105,17,13,57,692,2363,7220,3834,7617,1798,4801,1018,37100,181
AR ED,St. Francis,Arkansas,5123,-90.77041245,35.00954437,28497,44.67,9958,13233,15264,14722,13521,47,116,91,202,2402,6992,15274,3829,10958,1000,6081,3877,38600,158
AR ED,Stone,Arkansas,5137,-92.12047958,35.90938759,9775,16.13,3866,4778,4997,9687,8,54,20,6,42,554,1814,5702,1705,4548,682,3036,830,36900,150
AR ED,Van Buren,Arkansas,5141,-92.53734207,35.58310699,14008,19.76,5698,6899,7109,13845,41,76,22,24,98,718,2413,7551,3326,7580,1882,4689,1009,44300,190
AR ED,White,Arkansas,5145,-91.73145676,35.28409195,54676,52.57,19823,26539,28137,52509,1703,233,119,112,372,3539,10160,32965,8012,21658,1835,14529,5294,43200,194
AR ED,Woodruff,Arkansas,5147,-91.25751495,35.18002319,9520,16.08,3630,4473,5047,6502,2991,15,11,1,17,692,2051,5094,1683,4169,539,2293,1337,29700,127
AR ED,Yell,Arkansas,5149,-93.31847,35.02907181,17759,19.1,6907,8641,9118,17172,371,75,98,43,177,1220,3336,10283,2920,7868,961,5075,1832,37000,182
AR WD,Ashley,Arkansas,5003,-91.78878021,33.20487595,24319,26.04,8890,11674,12645,17511,6616,46,48,98,220,1738,5113,13926,3542,9820,930,6847,2043,39200,182
AR WD,Baxter,Arkansas,5005,-92.36428452,36.23368263,31186,57.12,13486,14846,16340,30964,4,123,61,34,171,1459,4608,16012,9107,15549,2063,10859,2627,51800,240
AR WD,Benton,Arkansas,5007,-94.2371788,36.2972126,97499,115.66,37555,47531,49968,94968,124,1435,455,517,1359,6652,17532,55876,17439,41444,3889,27454,10101,58700,286
AR WD,Boone,Arkansas,5009,-93.07462311,36.30386543,28297,48.45,11131,13540,14757,28038,5,176,44,34,171,1817,5199,16403,4878,12380,1249,8470,2661,45900,230
AR WD,Bradley,Arkansas,5011,-92.15978241,33.44001198,11793,18.03,4545,5604,6189,8012,3648,13,2,118,191,778,2269,6518,2228,5092,547,3404,1141,30500,132
AR WD,Calhoun,Arkansas,5013,-92.53920746,33.54084015,5826,9.28,2185,2816,3010,4357,1447,5,7,10,31,412,1156,3298,960,2437,252,1775,410,34400,177
AR WD,Carroll,Arkansas,5015,-93.57593918,36.30777931,18654,29.42,7550,9015,9639,18416,6,146,54,32,194,1135,3386,10744,3389,8740,1190,5705,1845,47700,227
AR WD,Clark,Arkansas,5019,-93.18618774,34.06204796,21437,24.73,7907,10163,11274,16344,4913,55,76,49,127,1260,3529,13073,3575,8807,900,5439,2468,40000,185
AR WD,Columbia,Arkansas,5027,-93.22364426,33.23898125,25691,33.5,9638,12043,13648,16564,8992,53,62,20,77,1792,4941,14636,4322,10690,1052,6928,2710,39200,172
AR WD,Crawford,Arkansas,5033,-94.18716812,35.55807877,42493,71.54,15251,20775,21718,40974,374,658,389,98,459,3198,9142,25075,5078,16711,1460,11650,3601,43500,218
AR WD,Franklin,Arkansas,5047,-93.88266373,35.49049187,14897,24.46,5578,7392,7505,14644,99,98,24,32,179,955,2956,8484,2502,6228,650,4409,1169,36600,181
AR WD,Garland,Arkansas,5051,-93.09182358,34.58420372,73397,111.72,30836,34943,38454,66770,5604,484,228,311,777,4226,11591,41346,16234,37966,7130,21837,8999,53500,235
AR WD,Hempstead,Arkansas,5057,-93.70557022,33.74529266,21621,29.82,8212,10272,11349,14888,6464,74,37,158,291,1522,4463,12035,3601,9690,1478,6043,2169,34900,188
AR WD,Hot Spring,Arkansas,5059,-93.03549576,34.33342743,26115,42.46,10115,12620,13495,23066,2865,126,33,25,115,1699,5058,15014,4344,11378,1263,7856,2259,39200,179
AR WD,Howard,Arkansas,5061,-94.03324127,34.05241585,13569,23.64,4975,6513,7056,10504,2919,53,60,33,94,933,2818,7478,2340,5600,625,3661,1314,36200,187
AR WD,Johnson,Arkansas,5071,-93.43026352,35.54750824,18221,26.95,7059,8876,9345,17632,309,109,77,94,221,1143,3366,10548,3164,7984,925,5307,1752,38200,186
AR WD,Lafayette,Arkansas,5073,-93.60883713,33.25404167,9643,18.62,3584,4600,5043,5884,3711,20,17,11,41,617,2050,5269,1707,4523,939,2735,849,24300,138
AR WD,Little River,Arkansas,5081,-94.14204407,33.74306488,13966,27.07,5150,6775,7191,10820,2931,116,17,82,160,953,2976,8073,1964,6171,1021,3945,1205,40100,202
AR WD,Logan,Arkansas,5083,-93.70809174,35.22491074,20557,28.67,7628,10128,10429,20083,273,125,28,48,143,1402,4149,11502,3504,8539,911,5967,1661,34200,166
AR WD,Madison,Arkansas,5087,-93.69800949,36.03381157,11618,13.88,4392,5700,5918,11435,3,140,13,27,111,820,2295,6596,1907,5182,790,3515,877,34800,163
AR WD,Marion,Arkansas,5089,-92.64695358,36.27985191,12001,20.44,4970,5843,6158,11899,6,53,24,19,48,621,2014,6632,2734,6139,1169,3995,975,41800,196
AR WD,Miller,Arkansas,5091,-93.84856415,33.31413078,38467,62.14,14273,18372,20095,29464,8625,148,143,87,310,2878,8049,22145,5395,16172,1899,9754,4519,43200,245
AR WD,Montgomery,Arkansas,5097,-93.65684128,34.55042267,7841,10.13,3062,3868,3973,7718,8,93,11,11,56,450,1361,4473,1557,4269,1207,2526,536,32600,142
AR WD,Nevada,Arkansas,5099,-93.28897858,33.70375633,10101,16.29,3798,4826,5275,6856,3196,27,5,17,64,651,2089,5511,1850,4287,489,2896,902,30000,153
AR WD,Newton,Arkansas,5101,-93.2236557,35.92847824,7666,9.31,2818,3843,3823,7582,0,51,19,14,43,491,1652,4368,1155,3439,621,2345,473,32200,143
AR WD,Ouachita,Arkansas,5103,-92.83452606,33.59651756,30574,41.48,11712,14419,16155,19702,10739,44,67,22,133,2140,6118,17274,5042,13204,1492,8571,3141,38900,189
AR WD,Pike,Arkansas,5109,-93.65261078,34.15067101,10086,16.87,3855,4915,5171,9621,378,56,6,25,56,671,1962,5612,1841,4550,695,3081,774,32800,162
AR WD,Polk,Arkansas,5113,-94.19241714,34.46607971,17347,20.17,6827,8446,8901,17035,0,186,33,93,301,1132,3329,9540,3346,7732,905,5203,1624,36300,173
AR WD,Scott,Arkansas,5127,-94.0715332,34.89317513,10205,11.39,3957,5013,5192,10035,1,106,51,12,42,730,1870,5889,1716,4485,528,3088,869,34100,169
AR WD,Searcy,Arkansas,5129,-92.67937088,35.92197227,7841,11.74,3117,3829,4012,7750,2,66,15,8,32,461,1447,4377,1556,3739,622,2481,636,29400,135
AR WD,Sebastian,Arkansas,5131,-94.231884,35.19115257,99590,186.15,39298,48144,51446,88719,5666,1396,3291,518,1362,7238,18712,59649,13991,43621,4323,25630,13668,48600,244
AR WD,Sevier,Arkansas,5133,-94.21170425,33.97484398,13637,24.35,5118,6737,6900,12081,787,222,16,531,632,875,2690,7830,2242,5880,762,3904,1214,35000,176
AR WD,Union,Arkansas,5139,-92.52106857,33.20101929,46719,44.37,17819,22101,24618,32414,14061,79,91,74,222,3345,9469,26129,7776,20276,2457,13159,4660,40500,196
AR WD,Washington,Arkansas,5143,-94.21184158,35.99626923,113409,119.25,43372,56060,57349,108743,1676,1486,1043,461,1526,7873,20167,72585,12784,47349,3977,26706,16666,56500,274
AZ D,Apache,Arizona,4001,-109.5211983,35.23859215,61591,5.49,15981,30268,31323,12456,100,47803,94,1138,2599,7494,18170,31788,4139,26731,10750,11702,4279,19400,162
AZ D,Cochise,Arizona,4003,-109.7513428,31.89140129,97624,15.7,34546,49727,47897,79724,5078,790,2247,9785,28379,7519,20048,57601,12456,40238,5692,21983,12563,60600,287
AZ D,Coconino,Arizona,4005,-112.0426941,35.6319561,96591,5.19,29918,48099,48492,61836,1419,28233,861,4242,9696,8613,21296,61140,5542,42914,12996,18110,11808,82800,371
AZ D,Gila,Arizona,4007,-110.8491707,33.75510406,40216,8.46,15438,19648,20568,30776,99,5238,140,3963,7486,2845,7882,21674,7815,22961,7523,11945,3493,58300,246
AZ D,Graham,Arizona,4009,-109.7905541,33.0466423,26554,5.74,7930,13635,12919,20603,502,3951,106,1392,6682,2329,6473,14402,3350,9112,1182,5842,2088,51300,221
AZ D,Greenlee,Arizona,4011,-109.2740212,33.1139183,8008,4.36,2809,4051,3957,6835,28,183,16,946,3456,597,2142,4373,896,3582,773,1396,1413,40900,162
AZ D,La Paz,Arizona,4012,-114.030426,33.68169785,13844,3.09,5348,7096,6748,10335,118,2402,102,887,3139,1073,2596,7529,2646,10182,4834,3878,1470,57000,259
AZ D,Maricopa,Arizona,4013,-112.7676731,33.28017235,2122101,232.51,807560,1045778,1076323,1799420,74257,38017,36294,174113,345498,170182,385609,1301053,265257,952041,144481,511242,296318,85300,394
AZ D,Mohave,Arizona,4015,-113.6289558,35.60297394,93497,7.04,36801,46561,46936,88834,303,2145,569,1646,4919,6118,15007,53099,19273,50822,14021,26529,10272,75600,375
AZ D,Navajo,Arizona,4017,-110.2829247,35.28898811,77658,7.8,22189,38670,38988,34205,703,40417,264,2069,5652,8635,21197,41451,6375,38967,16778,16522,5667,51900,213
AZ D,Pima,Arizona,4019,-111.8875618,31.97849846,666880,72.59,261792,326266,340614,524976,20795,20330,11964,88815,163262,49910,116288,409206,91476,298207,36415,159467,102325,76500,338
AZ D,Pinal,Arizona,4021,-111.3268738,32.99384308,116379,21.78,39154,59648,56731,87219,3648,10785,502,14225,34062,9711,24387,66340,15941,52732,13578,28199,10955,53200,283
AZ D,Santa Cruz,Arizona,4023,-110.9092522,31.53788567,29676,23.97,8808,14131,15545,22159,97,64,164,7192,23221,2755,7450,16325,3146,9595,787,5817,2991,71500,280
AZ D,Yavapai,Arizona,4025,-112.3944359,34.71983719,107714,13.26,44778,52716,54998,103106,321,1740,490,2057,6899,5991,17193,58917,25613,54805,10027,32297,12481,84500,342
AZ D,Yuma,Arizona,4027,-114.0745087,32.77232552,106895,19.4,35791,54397,52498,80702,3056,1429,1393,20315,43388,9087,22522,60437,14849,46541,10750,23632,12159,64000,336
CA CD,Los Angeles,California,6037,-118.2886696,33.81497192,8863164,2177.68,2989552,4421398,4441766,5035103,992974,45508,954485,1835094,3351242,736285,1589825,5676467,860587,3163343,173791,1440830,1548722,226400,570
CA CD,Orange,California,6059,-117.7581062,33.6726265,2410556,3020.75,827066,1214060,1196496,1894593,42681,12165,249192,211925,564828,184873,404430,1600140,221113,875072,48006,496782,330284,252700,728
CA CD,Riverside,California,6065,-116.0516434,33.75208092,1170413,162.24,402067,585398,585015,894767,63591,11494,41591,158970,307514,104805,228456,682479,154673,483847,81780,270876,131191,139100,502
CA CD,San Bernardino,California,6071,-115.9590988,34.84334564,1418380,70.69,464737,710807,707573,1035328,114934,13411,59201,195506,378582,138342,300881,854257,124900,542332,77595,294248,170489,129200,489
CA CD,San Luis Obispo,California,6079,-120.3991623,35.3448391,217162,65.65,80281,112049,105113,193619,5727,2203,6195,9418,28923,13902,33629,138886,30745,90200,9919,48035,32246,215300,510
CA CD,Santa Barbara,California,6083,-120.0500374,34.50423622,369608,134.5,129802,185603,184005,285461,10402,3351,16429,53965,98199,26989,58898,238106,45615,138149,8347,71053,58749,250000,606
CA CD,Ventura,California,6111,-119.0552483,34.46922112,669016,359.3,217298,337493,331523,529166,15629,4909,34579,84733,176952,53778,129208,423025,63005,228478,11180,142262,75036,245300,695
CA ED,Alpine,California,6003,-119.808094,38.63030815,1113,1.51,450,590,523,806,6,281,5,15,74,79,203,747,84,1319,869,258,192,113200,349
CA ED,Amador,California,6005,-120.5399361,38.45858765,30039,51,10518,16912,13127,26894,1682,493,218,752,2520,1472,4184,19078,5305,12814,2296,7842,2676,118500,411
CA ED,Butte,California,6007,-121.5672989,39.72836685,182120,110.64,71665,89246,92874,165200,2361,3241,5170,6148,13606,12336,30548,107800,31436,76115,4450,43649,28016,94000,369
CA ED,Calaveras,California,6009,-120.4984741,38.1666851,31998,31.34,12649,15881,16117,30609,184,682,203,320,1714,2079,5858,18404,5657,19153,6504,9625,3024,113700,384
CA ED,Colusa,California,6011,-122.2827911,39.17120552,16275,14.13,5612,8319,7956,12442,96,343,357,3037,5424,1327,3676,9177,2095,6295,683,3564,2048,68900,272
CA ED,El Dorado,California,6017,-120.5061607,38.78350258,125995,73.47,46845,63018,62977,119118,606,1351,2456,2464,8777,9326,23919,77805,14945,61451,14606,32981,13864,155000,478
CA ED,Fresno,California,6019,-119.6255417,36.7439003,667490,111.66,220933,331066,336424,422839,33423,7119,57239,146870,236634,62508,146528,389185,69269,235563,14630,119876,101057,83600,363
CA ED,Glenn,California,6021,-122.380085,39.58997917,24798,18.8,8821,12375,12423,21176,137,511,821,2153,4958,2084,5476,13756,3482,9329,508,5451,3370,67400,278
CA ED,Inyo,California,6027,-117.2049789,36.62654495,18281,1.79,7565,8963,9318,15777,79,1826,178,421,1536,1196,3241,10453,3391,8712,1147,5017,2548,115800,317
CA ED,Kern,California,6029,-118.904808,35.30725861,543477,66.85,181480,273989,269488,378479,30131,7026,16541,111300,151995,52407,118580,319776,52714,198636,17156,107652,73828,82800,365
CA ED,Kings,California,6031,-119.8761673,36.1410675,101469,72.89,29082,54749,46720,65166,8243,1133,3594,23333,34551,9417,21371,62856,7825,30843,1761,15381,13701,70700,335
CA ED,Lassen,California,6035,-120.6600647,40.44446564,27598,6.06,8543,16108,11490,24215,1719,854,310,500,2883,1816,5007,17913,2862,10358,1815,5927,2616,70400,296
CA ED,Madera,California,6039,-119.7709541,37.2632885,88090,41.07,28370,44211,43879,63369,2494,1418,1264,19545,30400,7325,20058,49931,10776,30831,2461,18418,9952,86500,333
CA ED,Mariposa,California,6043,-119.8443298,37.53895569,14302,9.82,5604,7221,7081,13221,122,639,128,192,697,891,2375,8528,2508,7700,2096,3886,1718,99800,311
CA ED,Merced,California,6047,-120.6303673,37.18087769,178403,91.77,55331,90084,88319,120280,8523,1516,15128,32956,58107,18140,42526,101269,16468,58410,3079,30082,25249,90800,358
CA ED,Modoc,California,6049,-120.7227287,41.58606339,9678,2.38,3711,4934,4744,8803,78,406,40,351,701,632,1991,5417,1638,4672,961,2583,1128,49600,225
CA ED,Mono,California,6051,-118.7393799,38.07813072,9956,3.3,3961,5416,4540,9229,43,368,131,185,1126,814,1620,6906,616,10664,6703,2056,1905,159900,450
CA ED,Nevada,California,6057,-121.0006192,39.26299477,78510,81.78,30758,38599,39911,76371,180,849,635,475,3269,4896,14096,45267,14251,37352,6594,22886,7872,154700,489
CA ED,Placer,California,6061,-120.7377129,39.01123238,172796,122.03,64101,85578,87218,161948,1033,1861,3806,4148,13871,12563,32663,106945,20625,77879,13778,45319,18782,169000,496
CA ED,Plumas,California,6063,-120.7970963,40.02010155,19739,7.67,8125,9807,9932,18590,152,604,118,275,907,1265,3774,11345,3355,11942,3817,5482,2643,89900,272
CA ED,Sacramento,California,6067,-121.3396301,38.41701508,1041219,1072.32,394530,509619,531600,782326,97129,12068,96344,53352,121544,83917,191062,655982,110258,417574,23044,223360,171170,129800,462
CA ED,San Joaquin,California,6077,-121.2452889,37.8885994,480628,339.67,158156,243229,237399,353169,27094,5085,59690,35590,112673,42150,100100,284868,53510,166274,8118,91068,67088,121700,417
CA ED,Shasta,California,6089,-122.1817894,40.72018051,147036,38.84,55966,72022,75014,137977,1081,3954,2684,1340,5652,11253,29158,85915,20710,60552,4586,36123,19843,91300,358
CA ED,Sierra,California,6091,-120.5153465,39.58047104,3318,3.46,1336,1664,1654,3175,6,73,12,52,184,230,639,1870,579,2166,830,910,426,79300,280
CA ED,Siskiyou,California,6093,-122.5743065,41.49489403,43531,6.93,17306,21437,22094,40105,691,1797,383,555,2549,2923,8718,24708,7182,20141,2835,11636,5670,68300,270
CA ED,Solano,California,6095,-121.9900818,38.30241394,340421,408.18,113429,174346,166075,227292,45839,3070,43440,20780,45517,29743,68097,214718,27863,119533,6104,71309,42120,147300,521
CA ED,Stanislaus,California,6099,-120.9289169,37.60600471,370522,246.03,125375,182113,188409,297315,6450,4039,19223,43495,80897,33776,79595,217057,40094,132027,6652,76129,49246,124300,417
CA ED,Sutter,California,6101,-121.6699677,39.01978683,64415,107,23111,31869,32546,49521,1041,941,6079,6833,10592,5428,12975,38398,7614,24163,1052,13560,9551,91900,321
CA ED,Tehama,California,6103,-122.1820526,40.12317467,49625,16.8,18704,24402,25223,45593,256,966,353,2457,5124,3618,9897,27770,8340,20403,1699,12836,5868,68700,288
CA ED,Trinity,California,6105,-123.0214424,40.67153358,13063,4.09,5156,6665,6398,12133,53,624,100,153,431,883,2565,7653,1962,7540,2384,3591,1565,81800,292
CA ED,Tulare,California,6107,-118.7665634,36.26633453,311921,64.88,97861,155508,156413,204835,4618,3992,13319,85157,120893,29122,74015,174996,33788,105013,7152,58775,39086,73900,324
CA ED,Tuolumne,California,6109,-119.9144821,38.03380203,48456,21.69,17959,25699,22757,43792,1551,980,395,1738,3726,2784,8111,29549,8012,25175,7216,12679,5280,120400,392
CA ED,Yolo,California,6113,-121.9547424,38.62375832,141092,139.14,50972,69939,71153,107113,3172,1741,11914,17152,28182,10308,23696,93630,13458,53000,2028,26446,24526,137800,459
CA ED,Yuba,California,6115,-121.308548,39.27963638,58228,90.98,19776,29120,29108,45541,2437,1675,4917,3658,6728,6027,12426,33623,6152,21245,1469,10433,9343,67600,312
CA ND,Alameda,California,6001,-121.8911934,37.67926407,1279182,1738.02,479518,630342,648840,761815,229249,8894,192554,86670,181805,95932,207473,839997,135780,504109,24591,255386,224132,227200,570
CA ND,Contra Costa,California,6013,-121.9540291,37.90412903,803732,1101,300288,393448,410284,611003,74577,5336,77012,35804,91282,60743,141345,514148,87496,316170,15882,202894,97394,219400,613
CA ND,Del Norte,California,6015,-123.8769684,41.6862278,23460,23.3,7987,12744,10716,20210,858,1494,450,448,2414,1738,4589,14098,3035,9091,1104,5222,2765,84600,341
CA ND,Humboldt,California,6023,-123.8953362,40.73049545,119118,33.28,46420,59145,59973,107881,960,6568,2315,1394,4989,8538,22069,73880,14631,51134,4714,27301,19119,88000,344
CA ND,Lake,California,6033,-122.7160912,39.1261692,50631,40.12,20805,24780,25851,46486,933,1159,475,1578,3633,3370,8723,27066,11472,28822,8017,14822,5983,93300,351
CA ND,Marin,California,6041,-122.7251587,38.06806374,230096,439.95,95006,114001,116095,204128,8172,789,9442,7565,17930,13601,30335,157991,28169,99757,4751,58991,36015,354200,763
CA ND,Mendocino,California,6045,-123.4080277,39.37823105,80345,22.88,30419,40047,40298,72026,507,3304,925,3583,8248,5873,16079,47492,10901,33649,3230,18899,11520,123900,384
CA ND,Monterey,California,6053,-121.0762367,36.35268974,355660,107.68,112965,184755,170905,227008,22849,3017,27856,74930,119570,31297,66654,223012,34697,121224,8259,57202,55763,198200,566
CA ND,Napa,California,6055,-122.3453064,38.50570488,110765,148.88,41312,54892,55873,98469,1204,828,3604,6660,15941,7393,18327,66706,18339,44199,2887,26662,14650,183600,561
CA ND,San Benito,California,6069,-121.1030502,36.59313011,36697,26.44,11422,18547,18150,25617,204,353,804,9719,16800,3209,8192,21671,3625,12230,808,6984,4438,206600,491
CA ND,San Francisco,California,6075,-122.4212608,37.75450897,723959,15738.24,305584,362497,361462,387783,79039,3456,210876,42805,100717,35599,81284,501696,105380,328471,22887,105497,200087,298900,613
CA ND,San Mateo,California,6081,-122.2964134,37.40467644,649623,1453.3,241914,320188,329435,466885,35283,2987,109281,35187,114627,44793,97693,427139,79998,251782,9868,145552,96362,343900,711
CA ND,Santa Clara,California,6085,-121.6910286,37.18346024,1497577,1158.22,520180,759503,738074,1032190,56211,9269,261466,138441,314564,111821,247386,1008052,130318,540240,20060,307354,212826,289400,715
CA ND,Santa Cruz,California,6087,-121.9336739,37.06544113,229734,515.1,83566,114205,115529,192849,2632,1821,8512,23920,46797,16456,38248,149164,25866,91878,8312,50052,33514,256100,651
CA ND,Sonoma,California,6097,-122.9315949,38.48223877,388222,242.03,149011,190272,197950,351650,5547,4397,10774,15854,41223,28319,67457,240311,52135,161062,12051,93763,55248,201400,576
CA SD,Imperial,California,6025,-115.2833901,33.02940178,109303,26.19,32842,53828,55475,73615,2622,1859,2135,29072,71935,9986,27473,60736,11108,36559,3717,18907,13935,72500,313
CA SD,San Diego,California,6073,-116.8385811,33.0230484,2498016,593.07,887403,1272927,1225089,1872256,159306,20066,198311,248077,510781,195338,415608,1613930,273140,946240,58837,477579,409824,186700,564
CO D,Adams,Colorado,8001,-104.374485,39.86391449,265038,214.61,96353,131564,133474,229808,8833,2396,6876,17125,49179,22946,53985,167953,20154,106947,10594,63129,33224,71500,373
CO D,Alamosa,Colorado,8003,-105.7435875,37.54396248,13617,18.94,4721,6681,6936,11219,69,126,120,2083,5254,1167,2803,8382,1265,5254,533,2952,1769,48100,241
CO D,Arapahoe,Colorado,8005,-104.3749123,39.64445877,391511,489.39,154710,190867,200644,349314,23279,2099,11115,5704,21743,30756,75474,256110,29171,168665,13955,98376,56334,93000,404
CO D,Archuleta,Colorado,8007,-106.974247,37.20746613,5345,3.95,2010,2724,2621,4664,7,107,29,538,1244,443,1138,3143,621,3951,1941,1421,589,79600,285
CO D,Baca,Colorado,8009,-102.5572128,37.31590462,4556,1.78,1872,2253,2303,4320,1,64,10,161,255,301,850,2465,940,2434,562,1365,507,31100,148
CO D,Bent,Colorado,8011,-103.0547867,37.95098305,5048,3.33,1865,2623,2425,4588,33,37,30,360,1371,336,990,2769,953,2332,467,1292,573,24300,207
CO D,Boulder,Colorado,8013,-105.3675461,40.08342171,225339,303.69,88402,112950,112389,210190,1959,1313,5508,6369,15195,15777,36102,156251,17209,94621,6219,54031,34371,102800,449
CO D,Chaffee,Colorado,8015,-106.2378731,38.74179459,12684,12.58,4848,6797,5887,12100,202,118,38,226,1200,695,2196,7705,2088,6547,1699,3439,1409,62900,247
CO D,Cheyenne,Colorado,8017,-102.6103973,38.82276344,2397,1.34,904,1219,1178,2358,0,4,3,32,83,216,540,1265,376,1083,179,633,271,38200,224
CO D,Clear Creek,Colorado,8019,-105.6523857,39.70242882,7619,19.24,3153,3954,3665,7444,20,32,39,84,254,535,1444,5096,544,4811,1658,2268,885,90800,335
CO D,Conejos,Colorado,8021,-106.1860619,37.19390297,7453,5.8,2492,3706,3747,6387,12,31,23,1000,4463,634,1949,3827,1043,3574,1082,1974,518,35400,150
CO D,Costilla,Colorado,8023,-105.4545631,37.31662941,3190,2.6,1192,1594,1596,2664,8,18,40,460,2452,231,681,1759,519,1743,551,922,270,35400,116
CO D,Crowley,Colorado,8025,-103.7714272,38.30976677,3946,4.99,1165,2461,1485,3462,262,72,31,119,912,220,609,2542,575,1415,250,814,351,26500,167
CO D,Custer,Colorado,8027,-105.405838,38.06468201,1926,2.6,770,964,962,1886,0,27,3,10,55,114,396,1132,284,2216,1446,569,201,58900,223
CO D,Delta,Colorado,8029,-107.9324989,38.93733978,20980,18.39,8372,10353,10627,20144,60,129,54,593,1915,1237,3910,11142,4691,10082,1710,6239,2133,51200,219
CO D,Denver,Colorado,8031,-104.9411926,39.71498299,467610,4212.7,210952,227517,240093,337198,60046,5381,11005,53980,107382,34764,68115,299926,64805,239636,28684,103765,107187,79000,339
CO D,Dolores,Colorado,8033,-108.453495,37.76205635,1504,1.41,581,764,740,1445,0,41,1,17,48,97,318,869,220,947,366,465,116,40400,202
CO D,Douglas,Colorado,8035,-104.9849396,39.34268379,60391,71.81,20844,30314,30077,58682,407,267,508,527,1910,5746,12974,39147,2524,22291,1447,17756,3088,119500,520
CO D,Eagle,Colorado,8037,-106.6404114,39.63230515,21928,12.98,8354,11553,10375,20078,46,113,100,1591,2917,1953,3652,15621,702,15226,6872,4802,3552,135900,544
CO D,El Paso,Colorado,8041,-104.5528908,38.82039642,397014,186.48,146965,199334,197680,341400,28593,3242,9841,13938,34473,33770,75656,255914,31674,165056,18091,84318,62647,81700,364
CO D,Elbert,Colorado,8039,-104.1840286,39.21043587,9646,5.21,3377,4831,4815,9419,47,68,43,69,211,707,2260,5942,737,3997,620,2800,577,92400,370
CO D,Fremont,Colorado,8043,-105.4752007,38.47143555,32273,20.98,11713,16757,15516,30555,848,329,112,429,2759,1771,5527,18913,6062,13683,1970,8537,3176,57900,265
CO D,Garfield,Colorado,8045,-107.5167284,39.72127342,29974,10.15,11266,15264,14710,29148,82,215,124,405,1673,2434,5836,18724,2980,12517,1251,6518,4748,90400,359
CO D,Gilpin,Colorado,8047,-105.5368538,39.83769417,3070,20.6,1308,1624,1446,2993,14,36,13,14,109,191,544,2115,220,2438,1130,988,320,74600,351
CO D,Grand,Colorado,8049,-106.1394081,40.07941246,7966,4.3,3168,4230,3736,7762,16,29,38,121,243,524,1491,5340,611,9985,6817,1828,1340,81400,367
CO D,Gunnison,Colorado,8051,-106.9352951,38.69962502,10273,3.17,3855,5442,4831,10009,63,69,48,84,366,666,1466,7484,657,7294,3439,1979,1876,79000,297
CO D,Hinsdale,Colorado,8053,-107.2896004,37.78612709,467,0.42,214,246,221,463,1,3,0,0,4,18,68,322,59,1254,1040,127,87,84200,275
CO D,Huerfano,Colorado,8055,-104.9286728,37.64326859,6009,3.79,2446,2924,3085,5569,27,78,14,321,2428,360,1192,3195,1262,3913,1467,1711,735,36100,173
CO D,Jackson,Colorado,8057,-106.3559532,40.66205978,1605,0.99,632,855,750,1480,0,26,1,98,118,119,292,1022,172,1326,694,413,219,49800,223
CO D,Jefferson,Colorado,8059,-105.2159348,39.51716805,438430,570.87,166545,216356,222074,414542,3231,2428,7630,10599,30791,33278,82890,286868,35394,178611,12066,116830,49715,93600,416
CO D,Kiowa,Colorado,8061,-102.77174,38.43569946,1688,0.96,657,824,864,1648,0,11,0,29,55,101,384,871,332,878,221,453,204,31300,179
CO D,Kit Carson,Colorado,8063,-102.6032372,39.29859352,7140,3.31,2785,3537,3603,6794,9,23,11,303,468,549,1534,3902,1155,3224,439,1984,801,46700,206
CO D,La Plata,Colorado,8067,-107.9218445,37.31498909,32284,19.08,11976,16256,16028,29022,71,1602,179,1410,3586,2213,6031,20820,3220,15412,3436,7818,4158,85100,354
CO D,Lake,Colorado,8065,-106.3542442,39.21300888,6007,15.85,2382,3097,2910,5483,13,49,21,441,1434,495,1179,3845,488,3527,1145,1534,848,48700,271
CO D,Larimer,Colorado,8069,-105.5684319,40.62539864,186136,71.48,70472,92046,94090,175971,1114,1063,2777,5211,12227,13552,33509,121218,17857,77811,7339,44297,26175,83900,368
CO D,Las Animas,Colorado,8071,-104.104702,37.39970398,13765,2.89,5421,6699,7066,11924,34,122,66,1619,6080,883,2621,7533,2728,6975,1554,3634,1787,44700,167
CO D,Lincoln,Colorado,8073,-103.5954514,39.03560257,4529,1.75,1817,2221,2308,4444,4,29,12,40,75,345,848,2454,882,2204,387,1276,541,43800,226
CO D,Logan,Colorado,8075,-103.1148834,40.71509361,17567,9.66,6978,8570,8997,16842,20,49,42,614,1393,1229,3453,10141,2744,7824,846,4654,2324,43200,214
CO D,Mesa,Colorado,8077,-108.2247124,38.92782593,93145,28.15,36250,45181,47964,88177,391,659,632,3286,7563,6571,18429,54694,13451,39208,2958,23534,12716,62700,275
CO D,Mineral,Colorado,8079,-106.9190712,37.68104744,558,0.64,247,287,271,547,0,5,0,6,27,49,76,349,84,1201,954,174,73,53800,231
CO D,Moffat,Colorado,8081,-108.1770134,40.60697746,11357,2.4,4178,5747,5610,10923,11,87,40,296,698,975,2703,6760,919,5235,1057,2785,1393,52900,251
CO D,Montezuma,Colorado,8083,-108.506527,37.31392479,18672,9.16,6762,9098,9574,15943,12,2141,46,530,1612,1555,4277,10526,2314,8050,1288,5018,1744,58100,257
CO D,Montrose,Colorado,8085,-108.2759705,38.41148376,24423,10.9,9405,11911,12512,23407,68,136,72,740,2736,1564,5134,13728,3997,10353,948,6768,2637,60000,257
CO D,Morgan,Colorado,8087,-103.7979469,40.25450706,21939,17.19,8139,10750,11189,19320,61,124,83,2351,4034,1817,4690,12109,3323,9230,1091,5089,3050,52000,245
CO D,Otero,Colorado,8089,-103.7227097,37.94652176,20185,16.19,7593,9720,10465,16727,118,199,120,3021,7104,1476,4363,10897,3449,8739,1146,5080,2513,38200,201
CO D,Ouray,Colorado,8091,-107.8162727,38.11445045,2295,4.23,947,1158,1137,2249,0,10,2,34,103,127,443,1426,299,1507,560,706,241,91800,291
CO D,Park,Colorado,8093,-105.753521,39.12714386,7174,3.27,2775,3676,3498,7031,40,52,16,35,206,476,1480,4692,526,7247,4472,2236,539,80100,366
CO D,Phillips,Colorado,8095,-102.3544312,40.58710861,4189,6.09,1712,1979,2210,4174,0,2,9,4,170,281,819,2210,879,1960,248,1238,474,41600,171
CO D,Pitkin,Colorado,8097,-106.9400559,39.16646576,12661,13.08,5877,6648,6013,12328,41,48,142,102,475,708,1424,9972,557,9837,3960,3082,2795,452800,663
CO D,Prowers,Colorado,8099,-102.3875618,37.95239449,13347,8.19,4984,6512,6835,11397,43,95,36,1776,3102,1092,3073,7484,1698,5855,871,3264,1720,39400,196
CO D,Pueblo,Colorado,8101,-104.5450096,38.12331581,123051,51.77,47057,59515,63536,104304,2253,991,729,14774,44090,8542,23937,71895,18677,50872,3815,31946,15111,51300,252
CO D,Rio Blanco,Colorado,8103,-108.0431519,39.92920494,5972,1.85,2181,3033,2939,5807,9,42,22,92,236,446,1348,3609,569,2803,622,1441,740,57400,249
CO D,Rio Grande,Colorado,8105,-106.3712921,37.6115818,10770,11.8,3930,5323,5447,9675,7,81,15,992,4342,840,2411,5955,1564,5277,1347,2686,1244,47400,214
CO D,Routt,Colorado,8107,-107.0341644,40.45771027,14088,5.95,5483,7535,6553,13913,8,64,41,62,353,999,2548,9733,808,9252,3769,3353,2130,94900,396
CO D,Saguache,Colorado,8109,-106.2235146,38.09902954,4619,1.46,1643,2370,2249,3699,11,140,7,762,2106,379,1087,2578,575,2306,663,1103,540,39000,174
CO D,San Juan,Colorado,8111,-107.7088089,37.79912376,745,1.92,287,415,330,711,1,4,2,27,118,47,175,475,48,481,194,177,110,51000,276
CO D,San Miguel,Colorado,8113,-108.3881722,37.95996094,3653,2.84,1489,1936,1717,3609,5,13,10,16,102,255,570,2670,158,2635,1146,827,662,151800,447
CO D,Sedgwick,Colorado,8115,-102.3491669,40.87011147,2690,4.98,1141,1309,1381,2614,10,15,32,19,230,142,511,1417,620,1414,273,811,330,29200,138
CO D,Summit,Colorado,8117,-106.1077538,39.63669586,12881,21.22,5295,7012,5869,12574,32,79,96,100,323,943,1705,9933,300,17091,11796,2551,2744,121500,492
CO D,Teller,Colorado,8119,-105.1248703,38.88673782,12468,22.3,4720,6331,6137,12189,24,106,52,97,322,944,2652,7970,902,7565,2845,3637,1083,83300,387
CO D,Washington,Colorado,8121,-103.2414131,39.9965477,4812,1.91,1915,2408,2404,4721,1,13,8,69,139,311,989,2663,849,2307,392,1383,532,37100,167
CO D,Weld,Colorado,8123,-104.3115501,40.49892616,131821,33.04,47470,65089,66732,117247,567,785,1133,12089,27502,10389,26624,81354,13454,51138,3668,29040,18430,67500,307
CO D,Yuma,Colorado,8125,-102.4245071,39.99912071,8954,3.79,3472,4381,4573,8769,2,39,12,132,284,592,1998,4859,1505,4082,610,2437,1035,47000,203
CT D,Fairfield,Connecticut,9001,-73.40117264,41.33214188,827645,1309.56,305011,398672,428973,700350,81519,1226,17332,27218,70818,56957,130168,530452,110068,324355,19344,208121,96890,249800,599
CT D,Hartford,Connecticut,9003,-72.72022247,41.79278755,851783,1152.62,324691,409806,441977,711315,87255,1425,13347,38441,71575,57998,134345,539814,119626,341812,17121,203635,121056,168900,491
CT D,Litchfield,Connecticut,9005,-73.20199585,41.76252174,174092,189.02,66371,85227,88865,170361,1631,327,1411,362,1907,11997,28722,108780,24593,74274,7903,48584,17787,166300,481
CT D,Middlesex,Connecticut,9007,-72.53004837,41.45435333,143196,383.9,54651,69930,73266,134489,6002,230,1538,937,2881,9533,21868,93024,18771,61593,6942,38474,16177,175100,537
CT D,New Haven,Connecticut,9009,-72.93182755,41.40199852,804219,1318.39,304730,386016,418203,687491,82011,1536,10484,22697,51003,56626,125992,503624,117977,327079,22349,191497,113233,165200,493
CT D,New London,Connecticut,9011,-72.12857437,41.49588585,254957,381.1,93245,128950,126007,234274,12123,1338,3389,3833,8455,18920,41086,164529,30422,104461,11216,60315,32930,149200,493
CT D,Tolland,Connecticut,9013,-72.30729294,41.81080437,128699,312.38,44309,64297,64402,122785,2625,221,2446,622,2216,8775,20231,88138,11555,46677,2368,31901,12408,165000,531
CT D,Windham,Connecticut,9015,-72.02303696,41.82909393,102525,199.08,37471,49975,52550,98288,1103,351,751,2032,4261,7550,18813,63267,12895,40599,3128,24954,12517,126800,406
DC D,Washington,District of Columbia,11001,-77.01691818,38.89077568,606900,9633.33,249634,282970,323930,179667,399604,1466,11214,14949,32710,37351,79741,411961,77847,278489,28855,97108,152526,123900,441
DE D,Kent,Delaware,10001,-75.53628159,39.09855461,110993,186.54,39655,54289,56704,87300,20631,614,1420,1028,2540,9274,20900,69347,11472,42106,2451,27448,12207,80800,343
DE D,New Castle,Delaware,10003,-75.60177612,39.56653404,441946,1116.03,164161,213895,228051,355399,72834,760,7048,5905,11804,31857,74222,285535,50332,173560,9399,112040,52121,110900,460
DE D,Sussex,Delaware,10005,-75.38546753,38.7022686,113229,120.2,43681,54784,58445,92395,18995,645,589,605,1476,7693,19395,67210,18931,74253,30572,34325,9356,79800,278
FL MD,Baker,Florida,12003,-82.25487518,30.3589983,18486,31.6,5554,9655,8831,15579,2768,60,50,29,200,1439,4192,11379,1476,5975,421,4405,1149,53400,225
FL MD,Bradford,Florida,12007,-82.22508621,29.93181038,22515,76.84,7193,12429,10086,17692,4555,81,100,87,426,1419,3987,14385,2724,8099,906,5542,1651,49300,223
FL MD,Brevard,Florida,12009,-80.74081039,28.30447578,398978,400.98,161365,197163,201815,358391,31417,1369,5379,2422,12261,26380,61074,245142,66382,185150,23785,111742,49623,75200,404
FL MD,Charlotte,Florida,12015,-81.97109985,26.89987946,110975,160.83,48433,53512,57463,105401,4243,216,738,377,2764,4832,12456,56198,37489,64641,16208,38559,9874,77200,412
FL MD,Citrus,Florida,12017,-82.46087265,28.8574543,93515,148.67,40573,44711,48804,90411,2206,283,395,220,1702,4441,12025,47766,29283,49854,9281,33761,6812,66100,297
FL MD,Clay,Florida,12019,-81.81527328,29.95517063,105986,179.03,36663,52272,53714,97691,5513,367,1780,635,2764,8019,22515,66468,8984,40249,3586,26895,9768,82100,404
FL MD,Collier,Florida,12021,-81.36187363,26.1578722,152099,76.28,61703,75386,76713,139073,6986,428,584,5028,20734,9189,21151,87176,34583,94165,32462,43319,18384,121400,495
FL MD,Columbia,Florida,12023,-82.61968994,30.2141304,42613,53.53,15611,20940,21673,34423,7678,105,261,146,619,3112,8789,25058,5654,17818,2207,11509,4102,47300,222
FL MD,De Soto,Florida,12027,-81.80871964,27.18595409,23865,37.52,8222,12316,11549,19141,3726,97,99,802,2282,1636,4030,13576,4623,10310,2088,6084,2138,49600,272
FL MD,Duval,Florida,12031,-81.73997498,30.34345913,672971,867.23,257245,328737,344234,489604,163902,1904,12940,4621,17333,54428,119918,426831,71794,284673,27428,159444,97801,64000,355
FL MD,Flagler,Florida,12035,-81.31515503,29.46609116,28701,58.45,11880,13756,14945,25831,2366,52,283,169,1260,1477,4002,15877,7345,15215,3335,9090,2790,97500,435
FL MD,Glades,Florida,12043,-81.21317291,26.98920155,7591,9.95,2885,3848,3743,5987,922,431,16,235,605,487,1369,4245,1490,4624,1739,2256,629,57200,255
FL MD,Gulf,Florida,12045,-85.21360016,29.94356251,11504,20.58,4324,5779,5725,9253,2162,56,25,8,86,702,2121,6921,1760,6339,2015,3396,928,43200,193
FL MD,Hamilton,Florida,12047,-82.97119141,30.47813416,10930,21.14,3488,5727,5203,6448,4256,42,18,166,295,805,2351,6529,1245,4119,631,2657,831,36300,143
FL MD,Hardee,Florida,12049,-81.80943298,27.48884773,19499,30.61,6391,9885,9614,16382,1034,82,42,1959,4562,1513,4175,10849,2962,7941,1550,4844,1547,40300,257
FL MD,Hendry,Florida,12051,-81.22210312,26.60543919,25773,22.16,8402,13058,12715,18592,4311,543,99,2228,5757,2315,5763,14870,2825,9945,1543,5947,2455,61200,302
FL MD,Hernando,Florida,12053,-82.36241913,28.56035805,101115,211.98,42300,48483,52632,96108,3895,244,406,462,2962,5037,13611,51419,31048,50018,7718,35760,6540,71200,341
FL MD,Hillsborough,Florida,12057,-82.3522644,27.90711308,834054,792.07,324872,406217,427837,690352,110283,2454,11379,19586,106908,60887,141387,529647,102133,367740,42868,204966,119906,73100,374
FL MD,Lake,Florida,12069,-81.64558411,28.8119545,152104,159.44,63616,72929,79175,135619,14191,384,566,1344,4305,8576,21687,80055,41786,75707,12091,49839,13777,67800,311
FL MD,Lee,Florida,12071,-81.87273788,26.54205227,335113,417.33,140124,161917,173196,306200,22184,672,1894,4163,15094,19935,45635,186540,83003,189051,48927,101093,39031,84300,417
FL MD,Manatee,Florida,12081,-82.37110138,27.42589569,211707,283.41,91060,100147,111560,190328,16400,501,1227,3251,9424,12345,28271,111683,59408,115245,24185,64574,26486,79400,397
FL MD,Marion,Florida,12083,-82.08772659,29.2424221,194833,121.01,78177,93813,101020,167094,24844,638,945,1312,5860,12312,30780,108552,43189,94567,16390,59112,19065,61800,297
FL MD,Nassau,Florida,12089,-81.77595139,30.54906845,43941,67.71,16192,21735,22206,39069,4522,134,133,83,480,3254,8650,27573,4464,18726,2534,12715,3477,72600,327
FL MD,Orange,Florida,12095,-81.2652092,28.56268883,677491,744.5,254852,336061,341430,539061,103092,2036,13994,19308,64946,49862,111624,443971,72034,282686,27834,151062,103790,81400,441
FL MD,Osceola,Florida,12097,-81.26026917,27.99322605,107728,79.8,39150,52716,55012,96231,5902,360,1637,3598,12866,7907,19242,65614,14965,47959,8809,25730,13420,75700,438
FL MD,Pasco,Florida,12101,-82.41598511,28.32381439,281131,380.94,121674,133220,147911,270658,5457,784,1480,2752,9309,14514,35709,140085,90823,148965,27291,98384,23290,59000,329
FL MD,Pinellas,Florida,12103,-82.70445251,27.92914867,851659,3041.64,380635,397563,454096,770374,65868,1985,9790,3642,20069,44662,106794,478535,221668,458341,77706,263388,117247,73800,393
FL MD,Polk,Florida,12105,-81.61995697,28.00009632,405382,222.37,155969,196590,208792,341952,54385,1158,2486,5401,16600,28219,69523,232397,75243,186225,30256,109885,46084,61000,300
FL MD,Putnam,Florida,12107,-81.74541473,29.58395672,65070,88.77,25070,31739,33331,52019,11940,129,275,707,1688,4450,12092,36795,11733,31840,6770,19800,5270,49900,222
FL MD,Sarasota,Florida,12115,-82.31258011,27.1666584,277776,484.77,125493,130050,147726,262836,12073,483,1430,954,5882,12658,31053,144657,89408,157055,31562,95598,29895,87200,458
FL MD,Seminole,Florida,12117,-81.22228241,28.73798752,287529,964.86,107657,140587,146942,253621,24314,803,4843,3948,18606,20040,52867,184922,29700,117845,10188,72003,35654,91500,471
FL MD,St. Johns,Florida,12109,-81.46071243,29.93610096,83829,135.87,33426,40665,43164,75547,7328,182,509,263,1902,5335,13298,51405,13791,40712,7286,23517,9909,85800,394
FL MD,Sumter,Florida,12119,-82.12858963,28.63050461,31577,56.29,12119,15857,15720,26088,5102,164,55,168,762,1888,5117,17506,7066,15298,3179,9707,2412,49900,235
FL MD,Suwannee,Florida,12121,-83.00263977,30.16616821,26780,38.81,10034,12939,13841,22524,3949,104,65,138,417,1657,5441,15160,4522,11699,1665,7950,2084,45100,182
FL MD,Union,Florida,12125,-82.35154724,30.034338,10252,41.67,2658,6339,3913,7697,2379,58,38,80,335,680,1955,6852,765,2975,317,1857,801,43800,152
FL MD,Volusia,Florida,12127,-81.20672226,29.01982784,370712,333.07,153416,179481,191231,328530,33455,915,2739,5073,14840,21242,51781,213324,84365,180972,27556,110359,43057,69400,382
FL ND,Alachua,Florida,12001,-82.35074997,29.68022728,181596,201.55,71258,89128,92468,140787,34427,362,4556,1464,6779,11772,27743,125171,16910,79022,7764,38525,32733,66000,316
FL ND,Bay,Florida,12005,-85.68462753,30.30546856,126994,167.54,48938,62562,64432,109570,13713,949,2229,533,2256,9216,23033,79486,15259,65999,17061,32075,16863,61600,289
FL ND,Calhoun,Florida,12013,-85.15702057,30.40436459,11011,19.39,3793,5704,5307,9164,1658,133,13,43,118,781,2090,6544,1596,4468,675,3011,782,33200,149
FL ND,Dixie,Florida,12029,-83.16236496,29.5784502,10585,15.1,3916,5484,5101,9594,920,36,16,19,96,707,1881,6437,1560,6445,2529,3235,681,37500,160
FL ND,Escambia,Florida,12033,-87.39292908,30.66322327,262798,398.18,98608,127599,135199,201235,52618,2632,5048,1265,5013,19360,47020,165123,31295,112230,13622,63835,34773,57800,305
FL ND,Franklin,Florida,12037,-84.77694321,29.85825825,8967,16.45,3628,4378,4589,7776,1112,49,20,10,65,562,1591,5200,1614,5891,2263,2921,707,51700,206
FL ND,Gadsden,Florida,12039,-84.60548782,30.55607033,41105,79.35,13405,19535,21570,16686,23700,68,94,557,964,3178,8986,23756,5185,14859,1454,10131,3274,39500,168
FL ND,Gilchrist,Florida,12041,-82.80940247,29.74992561,9667,27.31,3284,5108,4559,8761,825,30,18,33,150,650,1772,5913,1332,4071,787,2806,478,45900,198
FL ND,Holmes,Florida,12059,-85.76207352,30.85499859,15778,32.33,5800,8008,7770,14740,782,174,50,32,176,978,2943,9383,2474,6785,985,4687,1113,36200,181
FL ND,Jackson,Florida,12063,-85.22945786,30.78497696,41375,43.92,14465,20982,20393,30085,10845,228,87,130,974,2431,7848,24926,6170,16320,1855,11142,3323,41400,165
FL ND,Jefferson,Florida,12065,-83.84163666,30.37630749,11296,18.55,3982,5401,5895,6334,4897,17,28,20,130,833,2435,6354,1674,4395,413,3055,927,43900,199
FL ND,Lafayette,Florida,12067,-83.12182999,30.04206276,5578,10.23,1721,3214,2364,4629,785,17,9,138,226,326,1054,3590,608,2266,545,1389,332,43700,175
FL ND,Leon,Florida,12073,-84.34231186,30.48511982,192493,284.75,74828,92601,99892,141712,46527,500,2694,1060,4715,12365,30760,133564,15804,81325,6497,42561,32267,75200,351
FL ND,Levy,Florida,12075,-82.77098846,29.30396843,25923,23.57,10079,12397,13526,22346,3211,108,134,124,490,1664,4615,14728,4916,12307,2228,8248,1831,49100,214
FL ND,Liberty,Florida,12077,-84.8453598,30.29338837,5569,6.65,1706,3172,2397,4508,982,29,12,38,108,332,1016,3594,627,2157,451,1378,328,39600,158
FL ND,Madison,Florida,12079,-83.49409103,30.45598412,16569,23.34,5522,8488,8081,9545,6915,54,9,46,231,1296,3264,9668,2341,6275,753,4196,1326,38800,148
FL ND,Okaloosa,Florida,12091,-86.58848953,30.69273472,143776,153.61,53313,72763,71013,125191,13007,776,3658,1144,4427,11225,26090,93142,13319,62569,9256,33154,20159,70600,342
FL ND,Santa Rosa,Florida,12113,-87.04379272,30.67899895,81608,79.7,29900,40644,40964,76385,3275,715,973,260,1223,6375,15799,51675,7759,32831,2931,22521,7379,65900,285
FL ND,Taylor,Florida,12123,-83.64229965,29.99031448,17111,16.17,6401,8301,8810,13791,3083,159,39,39,174,1333,3490,10015,2273,7908,1507,5027,1374,43600,188
FL ND,Wakulla,Florida,12129,-84.40238571,30.14221287,14202,23.63,5210,6948,7254,12226,1837,96,32,11,83,991,3029,8533,1649,6587,1377,4347,863,51800,245
FL ND,Walton,Florida,12131,-86.11951828,30.63463688,27760,26.04,11294,13637,14123,25300,1885,417,130,28,244,1746,4848,16581,4585,18728,7434,8850,2444,49700,233
FL ND,Washington,Florida,12133,-85.70614243,30.62029743,16919,28.68,6443,8194,8725,14029,2459,279,84,68,180,1091,3179,9663,2986,7703,1260,5188,1255,40100,177
FL SD,Broward,Florida,12011,-80.48336029,26.14620876,1255488,1036.74,528442,601177,654311,1025583,193447,2634,17130,16694,108439,78980,177638,738130,260740,628660,100218,359570,168872,91800,497
FL SD,Dade,Florida,12025,-80.50219345,25.56813335,1937094,990.84,692355,928411,1008683,1413015,397993,3066,26307,96713,953407,139714,328296,1198278,270806,771288,78933,375912,316443,86500,422
FL SD,Highlands,Florida,12055,-81.25690842,27.33737373,68432,66.5,29544,32462,35970,59735,6848,227,390,1232,3500,3492,9326,32717,22897,40114,10570,23055,6489,58500,282
FL SD,Indian River,Florida,12061,-80.61658859,27.70038414,90208,181.51,38057,43578,46630,81418,7660,136,473,521,2704,4918,12568,48130,24592,47128,9071,28561,9496,78800,422
FL SD,Martin,Florida,12085,-80.4888382,27.1115942,100900,181.8,43022,49522,51378,92119,6043,179,534,2025,4728,5162,12576,55472,27690,54199,11177,33079,9943,112700,442
FL SD,Monroe,Florida,12087,-81.05779266,25.46641064,78024,75.46,33583,40976,37048,71840,4203,258,630,1093,9580,4472,9083,52013,12456,46215,12632,20854,12729,151200,523
FL SD,Okeechobee,Florida,12093,-80.94079208,27.30064106,29627,38.48,10214,15142,14485,24984,1898,145,154,2446,3493,2284,5766,16770,4807,13266,3052,7397,2817,55600,312
FL SD,Palm Beach,Florida,12099,-80.4691124,26.65061855,863518,433.28,365558,414538,448980,732231,107705,1211,9020,13351,66613,53216,116337,483725,210240,461665,96107,262894,102664,98400,499
FL SD,St. Lucie,Florida,12111,-80.46028137,27.38226604,150171,258.47,58174,73443,76728,122159,24666,347,1031,1968,5952,10492,24130,84015,31534,73843,15669,41807,16367,73400,410
GA MD,Baker,Georgia,13007,-84.38732529,31.26733112,3615,10.42,1300,1662,1953,1747,1861,1,2,4,21,269,811,2059,476,1499,199,949,351,36600,125
GA MD,Baldwin,Georgia,13009,-83.2352562,33.05246353,39530,153.81,12165,20437,19093,22451,16706,44,271,58,349,2387,6771,26141,4231,14200,2035,8303,3862,54900,227
GA MD,Ben Hill,Georgia,13017,-83.23622513,31.75219059,16245,63.96,5972,7465,8780,11098,5088,16,34,9,78,1293,3689,8977,2286,6875,903,3962,2010,42300,163
GA MD,Berrien,Georgia,13019,-83.23109436,31.25321484,14153,31.04,5149,6891,7262,12407,1648,27,30,41,277,1079,2830,8445,1799,5858,709,3804,1345,40400,164
GA MD,Bibb,Georgia,13021,-83.68486786,32.8038559,149967,592.75,56307,69827,80140,86252,62526,190,791,208,916,11341,28522,90784,19320,61462,5155,32442,23865,57900,253
GA MD,Bleckley,Georgia,13023,-83.31641769,32.42487144,10430,47.63,3816,5021,5409,8000,2332,6,79,13,43,709,2040,6280,1401,4268,452,2866,950,41000,158
GA MD,Brooks,Georgia,13027,-83.5243454,30.85319805,15398,31.36,5392,7267,8131,8893,6390,27,27,61,253,1286,3306,8474,2332,5972,580,3883,1509,42200,143
GA MD,Butts,Georgia,13035,-83.96913528,33.31694412,15326,81.96,4696,8114,7212,9770,5438,38,49,31,113,1066,2881,9603,1776,5536,840,3371,1325,55500,242
GA MD,Calhoun,Georgia,13037,-84.61858368,31.53693199,5013,17.65,1794,2264,2749,2047,2953,12,1,0,8,360,1096,2705,852,2061,267,1239,555,29400,99
GA MD,Chattahoochee,Georgia,13053,-84.81966782,32.37931252,16934,67.74,2884,11157,5777,10091,5235,106,480,1022,1793,1362,3368,11969,235,3108,224,582,2302,42600,415
GA MD,Clarke,Georgia,13059,-83.3848114,33.9518013,87594,717.98,33170,41799,45795,61929,22935,134,2155,441,1491,5281,12271,62486,7556,35971,2801,14663,18507,73200,313
GA MD,Clay,Georgia,13061,-84.96207047,31.63659668,3364,17.16,1210,1506,1858,1310,2044,5,3,2,19,247,736,1769,612,1586,376,803,407,31300,99
GA MD,Clinch,Georgia,13065,-82.69272995,30.88179684,6160,7.5,2173,2976,3184,4456,1682,8,6,8,60,484,1360,3602,714,2423,250,1483,690,33600,115
GA MD,Colquitt,Georgia,13071,-83.75352859,31.18136215,36645,65.79,12980,17774,18871,27047,8861,75,42,620,1588,2681,7696,21095,5173,14350,1370,8885,4095,40700,167
GA MD,Cook,Georgia,13075,-83.42684174,31.18785667,13456,57.75,4825,6470,6986,9311,4031,34,30,50,217,1059,2802,7733,1862,5340,515,3617,1208,39500,168
GA MD,Crawford,Georgia,13079,-83.96632767,32.68703461,8991,27.41,3069,4445,4546,6090,2757,33,14,97,149,711,1830,5542,908,3279,210,2496,573,49500,155
GA MD,Crisp,Georgia,13081,-83.78223801,31.9106493,20011,72.77,7287,9158,10853,11783,8153,36,27,12,62,1533,4462,11223,2793,8318,1031,4452,2835,47100,173
GA MD,Decatur,Georgia,13087,-84.61728287,30.88797092,25511,43.53,8962,12157,13354,15228,10070,66,41,106,472,1925,5675,14611,3300,10120,1158,6455,2507,42700,173
GA MD,Dooly,Georgia,13093,-83.81964493,32.15779686,9901,24.94,3557,4502,5399,4991,4852,3,40,15,77,775,2215,5423,1488,4003,446,2445,1112,39200,116
GA MD,Dougherty,Georgia,13095,-84.21223831,31.54894447,96311,291.85,34163,45193,51118,47034,48387,250,452,188,816,8131,21186,57160,9834,37373,3210,17864,16299,57500,224
GA MD,Early,Georgia,13099,-84.86629486,31.29989529,11854,22.97,4263,5459,6395,6579,5226,31,16,2,45,907,2657,6409,1881,4714,451,2948,1315,40100,105
GA MD,Echols,Georgia,13101,-82.85693359,30.7276144,2334,5.54,816,1192,1142,2007,264,40,2,21,45,174,523,1405,232,942,126,664,152,40000,155
GA MD,Elbert,Georgia,13105,-82.8384552,34.12478828,18949,51.63,7115,9040,9909,13153,5718,8,49,21,134,1373,3715,10985,2876,7891,776,5205,1910,44600,157
GA MD,Franklin,Georgia,13119,-83.22505569,34.38725853,16650,63.07,6365,7961,8689,14906,1681,29,27,7,77,1074,2879,10108,2589,7613,1248,4965,1400,49500,163
GA MD,Grady,Georgia,13131,-84.22236633,30.87876987,20279,44.18,7354,9642,10637,13664,6395,77,22,121,289,1472,4254,11607,2946,8129,775,5368,1986,41400,166
GA MD,Greene,Georgia,13133,-83.17918396,33.55740929,11793,30.32,4083,5494,6299,5860,5887,13,1,32,96,891,2719,6504,1679,4699,616,3153,930,38800,152
GA MD,Hancock,Georgia,13141,-83.0159111,33.27245712,8908,18.95,2969,4043,4865,1802,7077,6,1,22,63,699,2094,4893,1222,3396,427,2290,679,29200,108
GA MD,Harris,Georgia,13145,-84.92673874,32.72660065,17788,38.34,6454,8769,9019,13103,4571,52,39,23,97,1131,3369,10924,2364,7814,1360,5315,1139,64500,191
GA MD,Hart,Georgia,13147,-82.95007324,34.35383034,19712,85.7,7459,9496,10216,15646,4002,17,35,12,76,1346,3545,11680,3141,8942,1483,5918,1541,51700,173
GA MD,Houston,Georgia,13153,-83.66635132,32.48565674,89208,234.76,32433,43779,45429,68097,19376,277,1030,428,1459,7319,17863,57096,6930,34785,2352,21106,11327,62100,315
GA MD,Irwin,Georgia,13155,-83.25081635,31.62028694,8649,23.89,3142,4069,4580,5992,2630,6,13,8,53,685,1797,4820,1347,3479,337,2304,838,40900,125
GA MD,Jasper,Georgia,13159,-83.69247437,33.32817078,8453,22.78,3036,4071,4382,5481,2940,15,10,7,57,626,1759,4913,1155,3637,601,2323,713,51100,170
GA MD,Jones,Georgia,13169,-83.5792923,33.01070213,20739,52.64,7300,10073,10666,15318,5317,32,48,24,79,1578,4210,13016,1935,7722,422,6113,1187,63500,231
GA MD,Lamar,Georgia,13171,-84.14804459,33.06461716,13038,70.1,4669,6173,6865,8559,4442,19,11,7,49,905,2539,7844,1750,5066,397,3267,1402,47600,190
GA MD,Lanier,Georgia,13173,-83.08214569,31.02171993,5531,28.51,1965,2688,2843,3978,1470,37,21,25,68,441,1175,3260,655,2202,237,1404,561,37500,168
GA MD,Lee,Georgia,13177,-84.13116455,31.76976871,16250,45.39,5199,8258,7992,13007,3135,31,46,31,112,1220,3996,9977,1057,5537,338,4048,1151,65300,267
GA MD,Lowndes,Georgia,13185,-83.24631882,30.82534409,75981,149.86,26311,37201,38780,50566,24241,230,647,297,991,6200,15041,47499,7241,28906,2595,15704,10607,60800,262
GA MD,Macon,Georgia,13193,-84.03937912,32.34712982,13114,32.46,4388,6092,7022,5358,7694,15,27,20,57,1032,3110,7165,1807,4848,460,3015,1373,35900,147
GA MD,Madison,Georgia,13195,-83.19300461,34.13127327,21050,73.86,7740,10292,10758,19051,1849,30,54,66,182,1526,4090,13121,2313,8428,688,6353,1387,53900,214
GA MD,Marion,Georgia,13197,-84.52093124,32.34656715,5590,15.27,1962,2683,2907,3250,2306,18,11,5,23,429,1169,3273,719,2152,190,1546,416,38400,126
GA MD,Miller,Georgia,13201,-84.71839905,31.1651783,6280,22.11,2336,2977,3303,4542,1726,6,4,2,20,428,1302,3504,1046,2602,266,1769,567,41200,130
GA MD,Mitchell,Georgia,13205,-84.24844742,31.25941277,20275,39.6,6798,9511,10764,10414,9647,53,16,145,260,1582,4846,11184,2663,7443,645,4762,2036,40800,141
GA MD,Monroe,Georgia,13207,-83.91617203,33.02323532,17113,43.11,5838,8384,8729,11597,5406,39,39,32,96,1201,3425,10553,1934,6401,563,4353,1485,62400,208
GA MD,Morgan,Georgia,13211,-83.47695923,33.62422371,12883,36.91,4399,6208,6675,8355,4459,12,26,31,117,958,2604,7613,1708,4814,415,3361,1038,55000,220
GA MD,Muscogee,Georgia,13215,-84.87427521,32.48679543,179278,822.38,65858,87123,92155,105762,68161,569,2510,2276,5294,14711,33730,111467,19370,70902,5044,35476,30382,58900,275
GA MD,Oconee,Georgia,13219,-83.46272278,33.83127785,17618,94.72,6156,8588,9030,16154,1315,33,88,28,178,1394,3664,10936,1624,6561,405,4770,1386,77900,335
GA MD,Oglethorpe,Georgia,13221,-83.0414238,33.87284279,9763,22.09,3581,4702,5061,7294,2419,23,7,20,66,716,1837,6027,1183,3936,355,2948,633,52500,181
GA MD,Peach,Georgia,13225,-83.85811996,32.56273079,21189,139.4,7142,10089,11100,10716,10075,72,72,254,378,1504,4261,13310,2114,7537,395,4937,2205,56700,204
GA MD,Pulaski,Georgia,13235,-83.45581436,32.2495079,8108,32.56,3098,3796,4312,5397,2632,7,16,56,83,541,1643,4666,1258,3470,372,2185,913,44900,141
GA MD,Putnam,Georgia,13237,-83.34132004,33.32362556,14137,41.1,5229,6926,7211,9300,4748,21,42,26,97,957,2681,8752,1747,7113,1884,3919,1310,59000,191
GA MD,Quitman,Georgia,13239,-85.02155304,31.87604713,2209,15.13,857,1026,1183,1093,1107,6,3,0,1,161,409,1252,387,1346,489,630,227,36400,99
GA MD,Randolph,Georgia,13243,-84.74549866,31.7731905,8023,18.61,2815,3650,4373,3310,4645,4,46,18,39,572,1785,4279,1387,3225,410,1877,938,33000,99
GA MD,Schley,Georgia,13249,-84.30080795,32.28575516,3588,21.23,1315,1729,1859,2317,1222,3,0,46,55,266,750,2092,480,1447,132,950,365,40400,150
GA MD,Seminole,Georgia,13253,-84.8710289,30.89711571,9010,40.04,3137,4450,4560,6031,2943,22,10,4,530,609,1756,5311,1334,3962,825,2465,672,42800,159
GA MD,Stewart,Georgia,13259,-84.85227585,32.07415295,5654,12.51,1982,2722,2932,2041,3578,16,16,3,26,376,1169,3135,974,2156,174,1403,579,30400,99
GA MD,Sumter,Georgia,13261,-84.1836319,32.04946232,30228,61.82,10484,13925,16303,15910,14045,100,113,60,189,2426,6409,17390,4003,11726,1242,6719,3765,45300,189
GA MD,Talbot,Georgia,13263,-84.48558044,32.70088768,6524,16.52,2345,3094,3430,2436,4067,13,3,5,51,453,1314,3876,881,2645,300,1825,520,35100,99
GA MD,Taylor,Georgia,13269,-84.23009109,32.55165291,7642,20.01,2804,3575,4067,4292,3300,2,11,37,58,549,1587,4403,1103,3162,358,2052,752,35800,130
GA MD,Terrell,Georgia,13273,-84.42499161,31.78681564,10653,31.61,3738,4887,5766,4251,6377,8,15,2,40,838,2326,5888,1601,4069,331,2378,1360,41200,125
GA MD,Thomas,Georgia,13275,-83.92402649,30.86972523,38986,70.75,14323,18138,20848,23971,14759,100,65,91,289,2971,8188,22390,5437,15936,1613,9805,4518,46400,213
GA MD,Tift,Georgia,13277,-83.49736786,31.46189499,34998,130.59,12184,17033,17965,24941,9371,42,183,461,1233,2778,7280,20987,3953,13359,1175,8062,4122,51600,194
GA MD,Turner,Georgia,13287,-83.62614059,31.70907021,8703,30.11,3043,4115,4588,5129,3534,10,20,10,35,712,2008,4761,1222,3426,383,2022,1021,37000,148
GA MD,Twiggs,Georgia,13289,-83.4143486,32.66949654,9806,27.09,3296,4707,5099,5290,4501,8,6,1,46,779,2218,5718,1091,3648,352,2637,659,37300,145
GA MD,Upson,Georgia,13293,-84.3223877,32.84685516,26300,80.67,9911,12434,13866,18897,7272,34,70,27,98,1781,4898,15412,4209,10667,756,6991,2920,41300,183
GA MD,Walton,Georgia,13297,-83.74613953,33.76291847,38586,116.93,13433,18680,19906,31177,7105,89,143,72,338,3001,7731,23562,4292,14514,1081,9490,3943,66700,273
GA MD,Washington,Georgia,13303,-82.79273605,32.99344826,19112,27.94,6739,8981,10131,9198,9874,10,25,5,65,1538,4095,10867,2612,7416,677,4855,1884,39600,148
GA MD,Webster,Georgia,13307,-84.54081345,32.07149982,2263,10.78,798,1056,1207,1127,1132,4,0,0,1,154,471,1310,328,898,100,637,161,30900,99
GA MD,Wilcox,Georgia,13315,-83.39348984,31.984869,7008,18.35,2511,3302,3706,4757,2225,9,2,15,30,510,1476,3806,1216,2865,354,1915,596,32000,125
GA MD,Wilkinson,Georgia,13319,-83.17879868,32.79327011,10228,22.68,3619,4869,5359,5910,4302,5,7,4,30,787,2222,6042,1177,4151,532,2934,685,40000,135
GA MD,Worth,Georgia,13321,-83.83880997,31.58572006,19745,34.34,6895,9522,10223,13540,6051,55,37,62,222,1617,4373,11461,2294,7597,702,5092,1803,45700,149
GA ND,Banks,Georgia,13011,-83.49954224,34.3465786,10308,44.05,3775,5202,5106,9874,364,18,31,21,52,684,2053,6386,1185,4193,418,3067,708,51100,202
GA ND,Barrow,Georgia,13013,-83.69707108,34.01161385,29721,182.34,10676,14533,15188,25962,3354,67,228,110,253,2523,5791,18159,3248,11812,1136,7716,2960,64000,281
GA ND,Bartow,Georgia,13015,-84.84264374,34.24528694,55911,122.61,20091,27588,28323,50413,5026,125,143,204,521,4587,10789,34918,5617,21757,1666,14397,5694,63100,308
GA ND,Carroll,Georgia,13045,-85.07481384,33.62064362,71422,142.56,25370,34579,36843,59646,11231,149,230,166,592,5224,13917,44986,7295,27736,2366,17616,7754,60300,264
GA ND,Catoosa,Georgia,13047,-85.117836,34.87568092,42464,262.12,15745,20525,21939,41822,357,91,152,42,205,2839,8184,26827,4614,16762,1017,11951,3794,56500,271
GA ND,Chattooga,Georgia,13055,-85.31290436,34.43793678,22242,71.06,8467,10678,11564,20220,1941,40,24,17,75,1516,4178,13237,3311,9142,675,6329,2138,34700,174
GA ND,Cherokee,Georgia,13057,-84.45940018,34.24740791,90204,212.75,31309,45338,44866,87690,1693,251,309,261,1059,8242,17101,58541,6320,33840,2531,25828,5481,86600,415
GA ND,Clayton,Georgia,13063,-84.34678268,33.50223732,182052,1230.08,65523,88714,93338,131729,43403,456,5046,1418,3746,15135,35720,120572,10625,71926,6403,38501,27022,70100,441
GA ND,Cobb,Georgia,13067,-84.55598831,33.9299984,447745,1305.38,171288,220072,227673,391959,44154,957,7918,2757,9403,33904,79340,306238,28263,189872,18584,110678,60610,97700,483
GA ND,Coweta,Georgia,13077,-84.74843979,33.34840012,53853,121.29,18930,25998,27855,41322,12194,107,149,81,385,4519,10832,33058,5444,20413,1483,13778,5152,68700,287
GA ND,Dade,Georgia,13083,-85.48448944,34.8062458,13147,74.7,4661,6417,6730,12972,101,42,26,6,64,884,2538,8295,1430,4998,337,3689,972,45100,213
GA ND,Dawson,Georgia,13085,-84.15282822,34.47533226,9429,44.9,3360,4764,4665,9328,4,82,7,8,39,730,1885,5976,838,4321,961,2863,497,80900,290
GA ND,De Kalb,Georgia,13089,-84.18607712,33.7949791,545837,2021.62,208690,261592,284245,292310,230425,998,16266,5838,15619,38657,90896,369828,46456,231520,22830,120587,88103,91600,468
GA ND,Douglas,Georgia,13097,-84.74167252,33.68972015,71120,350.34,24277,35250,35870,64734,5597,176,386,227,749,5602,14547,45974,4997,26495,2218,18880,5397,73400,445
GA ND,Fannin,Georgia,13111,-84.22098567,34.7938633,15992,41.65,6334,7706,8286,15927,5,38,15,7,62,927,2780,9427,2858,8363,2029,5307,1027,48000,179
GA ND,Fayette,Georgia,13113,-84.49684906,33.40924454,62415,313.64,21054,30816,31599,57729,3380,82,1053,171,994,4399,13828,39720,4468,22428,1374,18131,2923,116700,487
GA ND,Floyd,Georgia,13115,-85.23289871,34.33638573,81251,156.55,30518,38648,42603,69338,11106,138,409,260,831,5426,14043,49937,11845,32821,2303,20186,10332,50100,228
GA ND,Forsyth,Georgia,13117,-84.09202576,34.19228745,44083,195.06,15938,22076,22007,43573,14,98,81,317,635,3377,7996,28789,3921,17869,1931,13052,2886,96200,397
GA ND,Fulton,Georgia,13121,-84.39558323,33.84531784,648951,1215.26,257140,309748,339203,309901,324008,981,8380,5681,13373,48217,108968,426974,64792,297503,40363,127285,129855,97700,396
GA ND,Gilmer,Georgia,13123,-84.42441559,34.70006943,13368,31.31,5072,6576,6792,13258,37,16,20,37,102,863,2501,8186,1818,6986,1914,4079,993,56800,197
GA ND,Gordon,Georgia,13129,-84.87359238,34.50611496,35072,98.79,12778,17240,17832,33487,1321,86,124,54,200,2507,6991,21828,3746,13777,999,9218,3560,53100,260
GA ND,Gwinnett,Georgia,13135,-84.03326035,33.96184731,352910,811.29,126971,175529,177381,320971,18175,715,10219,2830,8470,30491,68223,237420,16776,137608,10637,86811,40160,95900,483
GA ND,Habersham,Georgia,13137,-83.50961685,34.62724113,27621,99.36,9966,14124,13497,25324,1554,76,512,155,342,1747,4787,17435,3652,11076,1110,7642,2324,57800,219
GA ND,Hall,Georgia,13139,-83.84107208,34.30471611,95428,251.79,34721,47066,48362,83108,8195,180,659,3286,4558,7161,17298,60687,10282,38315,3594,24097,10624,75400,340
GA ND,Haralson,Georgia,13143,-85.2077713,33.78012276,21966,77.62,8248,10540,11426,20438,1427,30,49,22,84,1653,4169,13221,2923,9016,768,6283,1965,47100,212
GA ND,Heard,Georgia,13149,-85.10931015,33.27743912,8628,29.55,3093,4208,4420,7418,1163,12,22,13,68,622,1827,5146,1033,3536,443,2441,652,43900,179
GA ND,Henry,Georgia,13151,-84.13811111,33.47576904,58741,182.99,20012,29036,29705,52112,6068,110,329,122,463,4730,11486,37596,4929,21275,1263,16691,3321,81200,408
GA ND,Jackson,Georgia,13157,-83.58512115,34.13411522,30005,87.73,10721,14872,15133,26942,2904,60,55,44,160,2161,5790,18448,3606,11775,1054,8056,2665,55300,230
GA ND,Jefferson,Georgia,13163,-82.44321442,33.0372715,17408,32.91,6093,8047,9361,7660,9700,14,16,18,41,1402,3846,9624,2536,7065,972,4213,1880,38300,133
GA ND,Lumpkin,Georgia,13187,-84.00967026,34.56987572,14573,50.78,4976,7221,7352,14002,238,237,45,51,213,994,2554,9550,1475,5729,753,3784,1192,66400,283
GA ND,Meriwether,Georgia,13199,-84.67296982,33.029953,22411,44.29,7637,10720,11691,12357,9989,26,17,22,121,1756,4784,12848,3023,8409,772,5710,1927,39900,172
GA ND,Murray,Georgia,13213,-84.76327133,34.78638458,26147,75.79,9363,12955,13192,25956,41,44,57,49,136,1997,5421,16597,2132,10207,844,7023,2340,52000,248
GA ND,Newton,Georgia,13217,-83.86080933,33.55755234,41808,150.93,14401,20017,21791,32171,9357,91,107,82,390,3400,8276,25721,4411,15494,1093,10210,4191,65400,315
GA ND,Paulding,Georgia,13223,-84.87681198,33.93392944,41611,133.37,14326,20767,20844,39711,1648,114,75,63,269,3861,8250,26455,3045,15237,911,11673,2653,68600,337
GA ND,Pickens,Georgia,13227,-84.45681763,34.46846771,14432,62.21,5386,7061,7371,14119,247,36,19,11,46,1036,2580,8876,1940,6403,1017,4317,1069,59500,234
GA ND,Pike,Georgia,13231,-84.38708115,33.08585358,10224,46.68,3526,5054,5170,8122,2053,11,21,17,54,751,2043,6156,1274,3797,271,2845,681,51600,218
GA ND,Polk,Georgia,13233,-85.16927338,34.00285339,33815,108.73,12519,16217,17598,28561,4791,59,87,317,483,2403,6537,20091,4784,13585,1066,9068,3451,41600,216
GA ND,Rabun,Georgia,13241,-83.38195801,34.85491562,11648,31.48,4630,5626,6022,11524,41,33,17,33,67,672,1886,6975,2115,7883,3253,3772,858,65900,205
GA ND,Rockdale,Georgia,13247,-84.04257202,33.65678215,54091,409.78,18337,26672,27419,48915,4355,114,515,192,594,4090,11237,34420,4344,19963,1626,13786,4551,86200,447
GA ND,Spalding,Georgia,13255,-84.2949791,33.26647949,54457,273.65,19426,26105,28352,38281,15785,88,233,70,316,4287,11023,32749,6398,20702,1276,11921,7505,57700,250
GA ND,Stephens,Georgia,13257,-83.28504181,34.56634712,23257,131.4,8949,11226,12031,20300,2787,32,101,37,144,1547,4061,14152,3497,10254,1305,6525,2424,49900,200
GA ND,Towns,Georgia,13281,-83.74468994,34.88526344,6754,40.93,2812,3276,3478,6734,0,13,4,3,18,310,866,3962,1616,4577,1765,2462,350,69400,189
GA ND,Troup,Georgia,13285,-85.04335403,33.0434227,55536,134.14,20371,26135,29401,38458,16694,56,288,40,289,4334,11172,32404,7626,22426,2055,13058,7313,54600,234
GA ND,Union,Georgia,13291,-83.97794724,34.81293869,11993,37.48,4709,5958,6035,11925,19,27,21,1,49,677,1996,7117,2203,6624,1915,3888,821,58300,212
GA ND,Walker,Georgia,13295,-85.29086685,34.78725243,58340,130.81,21697,28268,30072,55779,2246,133,131,51,214,3797,11226,35538,7779,23347,1650,16775,4922,45800,236
GA ND,White,Georgia,13311,-83.74819183,34.64759636,13006,53.74,4907,6330,6676,12522,360,37,71,16,98,781,2210,8077,1938,6082,1175,4022,885,69700,251
GA ND,Whitfield,Georgia,13313,-84.98211288,34.80189705,72462,249.01,26859,35617,36845,67533,2901,172,323,1533,2321,5151,13784,46325,7202,28832,1973,17960,8899,61200,289
GA SD,Appling,Georgia,13001,-82.29946136,31.7186842,15744,30.87,5834,7594,8150,12356,3268,17,41,62,138,1084,3500,9232,1928,6629,795,4470,1364,39200,175
GA SD,Atkinson,Georgia,13003,-82.88169861,31.29879951,6213,18.06,2210,3021,3192,4427,1658,2,3,123,154,496,1366,3613,738,2449,239,1611,599,30300,123
GA SD,Bacon,Georgia,13005,-82.42324066,31.56103992,9566,33.45,3442,4542,5024,8030,1480,11,19,26,83,720,2138,5540,1168,3859,417,2473,969,40500,166
GA SD,Brantley,Georgia,13025,-81.99975204,31.19162464,11077,24.89,3811,5506,5571,10438,596,32,5,6,36,839,2526,6719,993,4404,593,3226,585,36400,172
GA SD,Bryan,Georgia,13029,-81.45871353,31.98420238,15438,35.01,5070,7605,7833,13018,2293,27,73,27,136,1306,3698,9325,1109,5549,479,4045,1025,70200,226
GA SD,Bulloch,Georgia,13031,-81.7337532,32.39896393,43125,63.61,14984,20941,22184,31464,11226,60,227,148,360,2762,7075,28860,4428,16541,1557,9005,5979,59900,248
GA SD,Burke,Georgia,13033,-81.93535614,33.0508728,20579,24.7,7037,9714,10865,9762,10756,13,27,21,67,1870,4959,11399,2351,8329,1292,4981,2056,43500,139
GA SD,Camden,Georgia,13039,-81.66529083,30.93653965,30167,46.48,9459,16084,14083,23284,6079,150,405,249,622,3126,6024,19468,1549,10885,1426,5961,3498,66700,352
GA SD,Candler,Georgia,13043,-82.07973862,32.41011047,7744,31.23,2828,3677,4067,5238,2405,7,9,85,138,574,1530,4368,1272,3203,375,2029,799,44700,153
GA SD,Charlton,Georgia,13049,-82.14958572,30.71530247,8496,10.89,2911,4129,4367,6094,2355,33,10,4,35,777,1864,4964,891,3222,311,2293,618,41200,206
GA SD,Chatham,Georgia,13051,-81.14003754,31.98215103,216935,489.7,81111,103814,113121,130607,82608,461,2352,907,2782,17046,40240,131978,27671,91178,10067,47727,33384,63300,296
GA SD,Coffee,Georgia,13069,-82.87486267,31.58746815,29592,49.16,10541,14244,15348,21558,7504,31,114,385,557,2388,6466,17481,3257,11650,1109,7656,2885,45600,184
GA SD,Columbia,Georgia,13073,-82.24169922,33.53155136,66031,227.69,21841,32917,33114,56785,7282,156,1547,261,962,5404,14740,42015,3872,23745,1904,17322,4519,83700,362
GA SD,Dodge,Georgia,13091,-83.11856842,32.17160034,17607,34.93,6387,8647,8960,12620,4864,16,35,72,148,1225,3335,10549,2498,7094,707,4748,1639,33700,144
GA SD,Effingham,Georgia,13103,-81.33550644,32.34778786,25687,53.29,8759,12877,12810,21906,3620,54,60,47,169,2060,5915,15686,2026,9492,733,6906,1853,61300,266
GA SD,Emanuel,Georgia,13107,-82.32361984,32.56116104,20546,29.86,7420,9774,10772,13772,6681,20,44,29,82,1595,4650,11342,2959,8344,924,5184,2236,35200,146
GA SD,Evans,Georgia,13109,-81.86598587,32.15985107,8724,46.9,3144,4238,4486,5654,2963,2,19,86,109,698,1860,4919,1247,3512,368,2126,1018,44100,160
GA SD,Glascock,Georgia,13125,-82.59093094,33.226408,2357,16.37,867,1100,1257,2055,298,2,0,2,6,130,425,1382,420,1036,169,675,192,30700,111
GA SD,Glynn,Georgia,13127,-81.53535843,31.2489996,62496,151.69,23947,29678,32818,45989,15941,120,301,145,585,4579,11664,37546,8707,27724,3777,15591,8356,67200,295
GA SD,Jeff Davis,Georgia,13161,-82.63156128,31.81760502,12032,35.92,4357,5929,6103,10084,1834,10,24,80,144,892,2485,7324,1331,4792,435,3187,1170,39200,164
GA SD,Jenkins,Georgia,13165,-81.95616913,32.77835083,8247,23.36,2951,3877,4370,4811,3412,5,16,3,13,670,1765,4641,1171,3365,414,2099,852,39500,111
GA SD,Johnson,Georgia,13167,-82.70060349,32.66649246,8329,27.22,3010,3872,4457,5474,2839,3,8,5,35,638,1801,4611,1279,3389,379,2348,662,31600,105
GA SD,Laurens,Georgia,13175,-82.93240738,32.43078613,39988,49,14514,19136,20852,26485,13304,37,137,25,180,2968,8290,23175,5555,16504,1990,10285,4229,46500,182
GA SD,Liberty,Georgia,13179,-81.47843933,31.84572697,52745,102.02,15136,29218,23527,28935,20655,254,1195,1706,3236,6025,10018,34748,1954,16776,1640,6579,8557,60400,345
GA SD,Lincoln,Georgia,13181,-82.4382019,33.81410027,7442,37.97,2702,3593,3849,4600,2826,3,9,4,56,499,1489,4392,1062,3870,1168,2171,531,46000,122
GA SD,Long,Georgia,13183,-81.7334938,31.77329445,6202,15.43,2196,3120,3082,4685,1342,23,41,111,189,638,1242,3793,529,2638,442,1474,722,40500,259
GA SD,McDuffie,Georgia,13189,-82.47073364,33.4864502,20119,78.59,7270,9499,10620,12720,7320,38,29,12,84,1600,4311,11820,2388,8043,773,4990,2280,48000,182
GA SD,McIntosh,Georgia,13191,-81.42918777,31.50626945,8634,20.32,3186,4178,4456,4880,3719,13,5,17,63,650,1773,5106,1105,4276,1090,2659,527,37500,170
GA SD,Montgomery,Georgia,13209,-82.53062057,32.14666557,7163,29.36,2493,3530,3633,4998,2026,5,14,120,142,473,1389,4423,878,2885,392,1848,645,40100,121
GA SD,Pierce,Georgia,13229,-82.19541168,31.36823463,13328,38.74,4807,6468,6860,11683,1569,20,10,46,104,889,2864,8017,1558,5271,464,3847,960,41700,162
GA SD,Richmond,Georgia,13245,-82.0885582,33.38918304,189719,581.96,68675,92098,97621,104612,79639,529,3317,1622,3707,15248,36225,119146,19100,77288,8613,38762,29913,58500,305
GA SD,Screven,Georgia,13251,-81.62628555,32.76561928,13842,21.13,5048,6565,7277,7598,6209,14,15,6,51,1100,2953,7728,2061,5861,813,3712,1336,41800,160
GA SD,Taliaferro,Georgia,13265,-82.84912872,33.58604431,1915,9.77,727,904,1011,736,1167,1,4,7,21,132,398,1017,368,886,159,577,150,28600,99
GA SD,Tattnall,Georgia,13267,-81.99872971,32.04711914,17722,36.62,5845,9512,8210,12087,5177,23,51,384,547,1166,3117,11056,2383,6756,911,4026,1819,43500,156
GA SD,Telfair,Georgia,13271,-82.9328537,31.95597649,11000,24.77,4017,5041,5959,7202,3773,9,6,10,41,760,2285,6034,1921,4756,739,3073,944,31100,138
GA SD,Toombs,Georgia,13279,-82.33143997,32.13102055,24072,64.88,8804,11442,12630,17596,5637,37,148,654,824,1913,5183,13963,3013,9952,1148,5689,3115,49100,162
GA SD,Treutlen,Georgia,13283,-82.56261826,32.40054321,5994,29.67,2158,2762,3232,4001,1984,2,0,7,16,427,1276,3369,922,2437,279,1566,592,33300,113
GA SD,Ware,Georgia,13299,-82.41371918,31.01734257,35471,39.11,13046,17141,18330,26007,9238,58,123,45,190,2434,7066,20611,5360,14628,1582,9097,3949,41200,192
GA SD,Warren,Georgia,13301,-82.626297,33.43291283,6078,21.25,2130,2759,3319,2413,3656,2,7,0,2,499,1218,3360,1001,2443,313,1582,548,33200,121
GA SD,Wayne,Georgia,13305,-81.87794113,31.57581615,22356,34.55,7922,10855,11501,17884,4358,41,44,29,177,1728,4767,13258,2603,8812,890,5728,2194,44500,166
GA SD,Wheeler,Georgia,13309,-82.74682999,32.10904694,4903,16.4,1786,2377,2526,3352,1474,4,5,68,101,366,1042,2702,793,2148,362,1356,430,29700,106
GA SD,Wilkes,Georgia,13317,-82.73880386,33.79275703,10597,22.55,4022,5059,5538,5650,4909,16,13,9,44,691,2117,5983,1806,4548,526,3112,910,42200,124
HI D,Hawaii,Hawaii,15001,-155.4200897,19.59916973,120317,29.82,41461,60665,59652,47736,615,868,68699,2399,11134,9447,25068,70716,15086,48253,6792,25336,16125,113000,428
HI D,Honolulu,Hawaii,15003,-157.9731293,21.4778204,836231,1403.07,265304,425994,410237,264372,25875,3532,526459,15993,56884,61931,142682,539786,91832,281683,16379,137910,127394,283600,615
HI D,Kauai,Hawaii,15007,-159.7714996,22.01572514,51177,82.54,16295,25951,25226,17712,211,178,32093,983,5580,3999,10116,30378,6684,17613,1318,9582,6713,171500,532
HI D,Maui,Hawaii,15009,-156.6484375,20.90378761,100374,86.38,33145,51201,49173,39766,494,521,57885,1708,7781,7846,19037,62132,11359,42160,9015,19083,14062,202100,658
IA ND,Allamakee,Iowa,19005,-91.3418808,43.29164886,13855,21.89,5268,6777,7078,13791,5,21,28,10,42,991,2783,7384,2697,6603,1335,3993,1275,39700,172
IA ND,Benton,Iowa,19011,-92.07012558,42.07629967,22429,31.24,8518,10999,11430,22317,20,31,42,19,93,1652,4567,12487,3723,9125,607,6368,2150,38600,189
IA ND,Black Hawk,Iowa,19013,-92.31310272,42.46703339,123798,216.05,46932,58910,64888,113656,8514,226,1005,397,912,8245,23157,75501,16895,49688,2756,31593,15339,44100,255
IA ND,Bremer,Iowa,19017,-92.32220459,42.77612305,22813,51.97,8394,11082,11731,22580,70,11,132,20,72,1378,4384,13245,3806,8847,453,6298,2096,45900,203
IA ND,Buchanan,Iowa,19019,-91.8430748,42.4693718,20844,36.44,7506,10219,10625,20695,38,24,43,44,112,1616,4803,11181,3244,8272,766,5630,1876,36300,188
IA ND,Buena Vista,Iowa,19021,-95.16030884,42.73616982,19965,34.72,7515,9690,10275,19458,56,16,396,39,160,1416,3759,11215,3575,8140,625,5098,2417,41400,218
IA ND,Butler,Iowa,19023,-92.79382706,42.73298264,15731,27.03,6036,7665,8066,15681,4,12,25,9,37,982,3167,8351,3231,6483,447,4685,1351,31600,162
IA ND,Calhoun,Iowa,19025,-94.66410446,42.38463402,11508,20.15,4684,5479,6029,11433,30,11,23,11,40,693,2196,5888,2731,5362,678,3358,1326,26700,165
IA ND,Carroll,Iowa,19027,-94.86874771,42.03445244,21423,37.58,7964,10358,11065,21325,7,19,56,16,57,1689,4670,11255,3809,8356,392,5844,2120,42000,207
IA ND,Cedar,Iowa,19031,-91.13579559,41.77135849,17381,29.86,6684,8476,8905,17274,16,17,49,25,109,1103,3530,9815,2933,7146,462,4885,1799,45700,220
IA ND,Cerro Gordo,Iowa,19033,-93.26436615,43.08155632,46733,82.13,19061,22111,24622,45738,303,44,260,388,994,3174,8396,27277,7886,20954,1893,13114,5947,45400,253
IA ND,Cherokee,Iowa,19035,-95.63279724,42.73917007,14098,24.43,5514,6803,7295,14000,20,37,32,9,51,930,2897,7660,2611,5973,459,3906,1608,32500,167
IA ND,Chickasaw,Iowa,19037,-92.32042694,43.06513023,13295,26.33,5040,6588,6707,13264,4,4,18,5,40,897,2840,7190,2368,5486,446,3950,1090,37200,183
IA ND,Clay,Iowa,19041,-95.16030884,43.08353233,17585,30.91,7074,8379,9206,17449,8,31,82,15,44,1245,3559,9880,2901,7659,585,4623,2451,41000,208
IA ND,Clayton,Iowa,19043,-91.25141907,42.86324883,19054,24.46,7218,9370,9684,18996,6,16,27,9,61,1332,3990,10281,3451,8344,1126,5409,1809,37200,173
IA ND,Crawford,Iowa,19047,-95.38757706,42.03589058,16775,23.49,6397,8196,8579,16569,59,33,88,26,98,1179,3438,9240,2918,6920,523,4573,1824,33900,198
IA ND,Delaware,Iowa,19055,-91.37243652,42.47068596,18035,31.2,6389,8864,9171,17959,11,15,32,18,68,1415,4125,9840,2655,7408,1019,4838,1551,44600,186
IA ND,Dickinson,Iowa,19059,-95.15963745,43.37613678,14909,39.13,6160,7148,7761,14830,16,22,26,15,52,817,2689,8306,3097,9723,3563,4667,1493,49400,210
IA ND,Dubuque,Iowa,19061,-90.81421661,42.48508072,86403,142.34,30799,41752,44651,85367,354,77,437,168,437,6017,17384,50861,12141,32053,1254,21931,8868,53600,252
IA ND,Emmet,Iowa,19063,-94.68790436,43.37598801,11569,29.36,4461,5595,5974,11484,19,12,31,23,63,710,2363,6313,2183,4914,453,3210,1251,27800,178
IA ND,Fayette,Iowa,19065,-91.84832382,42.86358452,21843,29.88,8490,10620,11223,21673,48,16,48,58,195,1491,4289,11880,4183,9262,772,6315,2175,30100,169
IA ND,Floyd,Iowa,19067,-92.79305267,43.0624218,17058,34.05,6721,8112,8946,16953,8,13,44,40,92,1119,3306,9284,3349,7233,512,4921,1800,36200,182
IA ND,Franklin,Iowa,19069,-93.26295471,42.73210144,11364,19.49,4579,5496,5868,11253,6,8,17,80,152,731,2195,6160,2278,5018,439,3296,1283,30500,186
IA ND,Grundy,Iowa,19075,-92.78665161,42.38021469,12029,24.01,4776,5768,6261,11986,7,9,21,6,34,775,2302,6542,2410,5158,382,3553,1223,38100,179
IA ND,Hamilton,Iowa,19079,-93.72372055,42.38227463,16071,27.9,6358,7794,8277,15902,9,21,90,49,116,1062,3019,9021,2969,6879,521,4515,1843,39900,214
IA ND,Hancock,Iowa,19081,-93.73939896,43.08206749,12638,22.13,4867,6141,6497,12524,1,5,26,82,129,913,2648,6789,2288,5236,369,3551,1316,36800,191
IA ND,Hardin,Iowa,19083,-93.25352478,42.38004684,19094,33.56,7611,9242,9852,18844,117,25,53,55,106,1119,3656,10270,4049,8419,808,5476,2135,33800,192
IA ND,Howard,Iowa,19089,-92.31789017,43.35767365,9809,20.74,3856,4767,5042,9768,5,7,20,9,24,674,1955,5057,2123,4155,299,3008,848,30400,152
IA ND,Humboldt,Iowa,19091,-94.21614456,42.78033638,10756,24.67,4339,5209,5547,10701,9,15,27,4,37,706,2036,5751,2263,4670,331,3159,1180,34600,189
IA ND,Ida,Iowa,19093,-95.54068375,42.38670158,8365,19.36,3222,4052,4313,8331,1,5,19,9,23,626,1708,4335,1696,3473,251,2309,913,29900,167
IA ND,Iowa,Iowa,19095,-92.06490326,41.68446732,14630,24.92,5713,7068,7562,14566,7,11,34,12,39,1050,2695,8128,2757,6003,290,4349,1364,43600,207
IA ND,Jackson,Iowa,19097,-90.52465057,42.21110535,19950,31.27,7527,9784,10166,19867,16,23,24,20,96,1424,4141,11073,3312,8426,899,5551,1976,41200,189
IA ND,Jones,Iowa,19105,-91.13215637,42.12080956,19444,33.76,6917,10060,9384,19056,299,35,22,32,95,1266,3724,11353,3101,7366,449,5090,1827,40800,193
IA ND,Kossuth,Iowa,19109,-94.21525574,43.20538139,18591,19.09,7194,9032,9559,18463,8,7,59,54,94,1298,3917,9850,3526,7765,571,5256,1938,33900,175
IA ND,Linn,Iowa,19113,-91.60234451,42.0736599,168767,233.1,65501,81973,86794,163164,3334,363,1401,505,1591,11930,30500,105842,20495,68357,2856,46140,19361,58500,308
IA ND,Lyon,Iowa,19119,-96.23230362,43.37919998,11952,20.33,4289,5845,6107,11896,2,15,35,4,11,947,2667,6189,2149,4561,272,3308,981,31800,144
IA ND,Mitchell,Iowa,19131,-92.79332733,43.35696411,10928,23.25,4253,5310,5618,10896,2,1,21,8,45,713,2135,5697,2383,4514,261,3328,925,34700,163
IA ND,Monona,Iowa,19133,-96.02005005,42.03768158,10034,14.4,4098,4779,5255,9982,5,26,13,8,30,604,1852,5197,2381,4555,457,3039,1059,27400,153
IA ND,O'Brien,Iowa,19141,-95.63398743,43.08628082,15444,26.91,5980,7433,8011,15343,8,32,52,9,39,1026,3098,8131,3189,6476,496,4484,1496,32700,171
IA ND,Osceola,Iowa,19143,-95.63258743,43.37721252,7267,18.21,2817,3527,3740,7228,3,9,16,11,16,535,1444,3882,1406,2998,181,2104,713,28000,167
IA ND,Palo Alto,Iowa,19147,-94.68790436,43.08274651,10669,18.98,4183,5156,5513,10616,8,23,18,4,24,680,2168,5632,2189,4826,643,2966,1217,28000,171
IA ND,Plymouth,Iowa,19149,-96.25397873,42.73966408,23388,27.07,8417,11488,11900,23260,48,14,53,13,58,1717,5075,12780,3816,8806,389,6295,2122,48800,214
IA ND,Pocahontas,Iowa,19151,-94.68660355,42.73578072,9525,16.51,3820,4611,4914,9485,4,10,17,9,32,650,1828,4969,2078,4193,373,2838,982,27000,156
IA ND,Sac,Iowa,19161,-95.13103485,42.38547707,12324,21.4,4914,6016,6308,12276,4,14,20,10,44,836,2442,6341,2705,5648,734,3564,1350,27100,160
IA ND,Sioux,Iowa,19167,-96.21948242,43.08875275,29903,38.89,9925,14498,15405,29608,25,32,209,29,66,2304,6637,16553,4409,10333,408,7762,2163,44700,191
IA ND,Tama,Iowa,19171,-92.54019547,42.0771904,17419,24.16,6768,8436,8983,16465,31,812,65,46,128,1139,3409,9487,3384,7417,649,5092,1676,32100,185
IA ND,Webster,Iowa,19187,-94.19418335,42.42884064,40342,56.19,15963,19261,21081,39022,883,113,159,165,490,2949,7534,22746,7113,17063,1100,11000,4963,37000,216
IA ND,Winnebago,Iowa,19189,-93.73984146,43.37676239,12122,30.23,4704,5869,6253,11965,31,17,77,32,97,793,2297,6714,2318,5030,326,3508,1196,39300,194
IA ND,Winneshiek,Iowa,19191,-91.84628296,43.29155922,20847,30.21,7256,10204,10643,20577,43,5,195,27,61,1413,3718,12503,3213,7726,470,5153,2103,49700,211
IA ND,Woodbury,Iowa,19193,-96.08353424,42.38743401,98276,112.57,36899,47285,50991,92098,1877,1697,1266,1338,2712,7465,20114,56254,14443,39071,2172,25280,11619,41000,255
IA ND,Worth,Iowa,19195,-93.26478577,43.37710571,7991,19.93,3239,3881,4110,7918,15,2,14,42,91,503,1479,4341,1668,3443,204,2470,769,33500,173
IA ND,Wright,Iowa,19197,-93.73914719,42.7328167,14269,24.64,5899,6791,7478,14175,10,15,41,28,92,955,2530,7625,3159,6636,737,4259,1640,32700,184
IA SD,Adair,Iowa,19001,-94.47868729,41.33330154,8409,14.75,3419,4044,4365,8377,1,5,19,7,35,554,1557,4317,1981,3714,295,2514,905,29400,164
IA SD,Adams,Iowa,19003,-94.70796967,41.0331955,4866,11.45,2005,2388,2478,4847,3,7,3,6,18,343,846,2620,1057,2234,229,1454,551,28700,174
IA SD,Appanoose,Iowa,19007,-92.87152481,40.74254799,13743,27.6,5609,6543,7200,13582,79,26,36,20,72,872,2586,7339,2946,6402,793,4177,1432,25600,174
IA SD,Audubon,Iowa,19009,-94.90777588,41.6834774,7334,16.52,2936,3517,3817,7324,1,3,6,0,22,507,1366,3765,1696,3247,311,2233,703,25300,149
IA SD,Boone,Iowa,19015,-93.93770981,42.0331707,25186,43.95,9827,12026,13160,25003,62,19,78,24,99,1664,4505,14486,4531,10371,544,7064,2763,40300,230
IA SD,Cass,Iowa,19029,-94.93505478,41.33403587,15128,26.78,6177,7208,7920,15074,9,22,15,8,46,962,2918,8079,3169,6788,611,4434,1743,34700,186
IA SD,Clarke,Iowa,19039,-93.79076004,41.03166199,8287,19.23,3343,3959,4328,8252,3,8,21,3,19,564,1604,4580,1539,3599,256,2419,924,36400,219
IA SD,Clinton,Iowa,19045,-90.52174377,41.8792038,51040,73.44,19757,24474,26566,49882,732,125,202,99,294,3585,10034,29270,8151,21296,1539,14061,5696,39100,235
IA SD,Dallas,Iowa,19049,-94.0436058,41.6804409,29755,50.35,11204,14529,15226,29534,63,42,70,46,176,2110,6176,17119,4350,11812,608,8332,2872,50100,242
IA SD,Davis,Iowa,19051,-92.41500473,40.74650192,8312,16.49,3093,4062,4250,8246,2,25,21,18,41,604,1658,4492,1558,3365,272,2400,693,28900,173
IA SD,Decatur,Iowa,19053,-93.79000473,40.7377491,8338,15.59,3207,4029,4309,8197,35,16,71,19,45,507,1434,4687,1710,3692,485,2272,935,22700,163
IA SD,Des Moines,Iowa,19057,-91.17943192,40.8896904,42614,102.93,16874,20356,22258,40809,1327,69,225,184,492,2798,8154,24738,6924,18248,1374,12279,4595,41600,242
IA SD,Fremont,Iowa,19071,-95.62931442,40.746521,8226,15.97,3217,3887,4339,8177,4,9,16,20,53,516,1630,4305,1775,3607,390,2327,890,32000,168
IA SD,Greene,Iowa,19073,-94.40550232,42.03335762,10045,17.59,4195,4775,5270,9994,5,10,30,6,30,636,1850,5297,2262,4707,512,3007,1188,27200,171
IA SD,Guthrie,Iowa,19077,-94.50213623,41.68277931,10935,18.53,4407,5245,5690,10883,7,19,14,12,35,630,2093,5916,2296,5179,772,3328,1079,29200,174
IA SD,Harrison,Iowa,19085,-95.81890869,41.68541527,14730,21.13,5656,7095,7635,14649,10,15,51,5,50,1025,2934,7903,2868,6175,519,4212,1444,33600,182
IA SD,Henry,Iowa,19087,-91.54491425,40.98614311,19226,44.1,7089,9594,9632,18710,211,44,215,46,127,1276,3571,11198,3181,7507,418,5212,1877,43800,229
IA SD,Jasper,Iowa,19099,-93.05644226,41.68667984,34795,47.6,13632,16990,17805,34446,65,62,175,47,194,2242,6670,20337,5546,14338,706,10172,3460,46000,240
IA SD,Jefferson,Iowa,19101,-91.95041275,41.02949524,16310,37.07,6309,7957,8353,16027,93,23,139,28,141,1062,2925,9922,2401,6739,430,4205,2104,47000,243
IA SD,Johnson,Iowa,19103,-91.60111618,41.6404705,96119,156.55,36067,47601,48518,89649,1979,176,3837,478,1435,6157,13190,69634,7138,37210,1143,18999,17068,76900,360
IA SD,Keokuk,Iowa,19107,-92.18069458,41.3345356,11624,20.04,4573,5640,5984,11565,6,19,27,7,19,753,2268,6193,2410,5024,451,3566,1007,23900,154
IA SD,Lee,Iowa,19111,-91.41839981,40.59225845,38687,74.11,14936,18928,19759,36990,1112,61,135,389,732,2561,7410,22236,6480,16443,1507,11061,3875,36300,208
IA SD,Louisa,Iowa,19115,-91.21981812,41.24760818,11592,28.84,4296,5834,5758,11206,86,36,18,246,425,803,2359,6688,1742,5044,748,3200,1096,39400,217
IA SD,Lucas,Iowa,19117,-93.33111954,41.03082466,9070,21,3766,4325,4745,9004,4,20,17,25,53,570,1664,4958,1878,4179,413,2799,967,30200,179
IA SD,Madison,Iowa,19121,-94.0241127,41.3353672,12483,22.17,4715,6085,6398,12402,5,37,16,23,67,832,2612,6789,2250,4995,280,3466,1249,42800,218
IA SD,Mahaska,Iowa,19123,-92.64501953,41.33606148,21522,37.69,8306,10478,11044,21254,42,16,179,31,92,1538,4086,12095,3803,8977,671,5815,2491,36400,209
IA SD,Marion,Iowa,19125,-93.10121155,41.33525276,30001,53.57,10815,14918,15083,29550,104,42,283,22,162,1974,5710,17475,4842,11420,605,7989,2826,48200,240
IA SD,Marshall,Iowa,19127,-93.00586319,42.03536797,38276,66.8,14890,18705,19571,37472,279,105,302,118,292,2498,7100,21996,6682,15862,972,10596,4294,42100,241
IA SD,Mills,Iowa,19129,-95.63619614,41.03265572,13202,30.07,4665,6545,6657,13110,22,28,17,25,72,837,2788,7765,1812,5004,339,3488,1177,47000,229
IA SD,Monroe,Iowa,19135,-92.87126541,41.03074646,8114,18.7,3196,3903,4211,8039,19,16,33,7,18,515,1544,4383,1672,3740,544,2458,738,27800,183
IA SD,Montgomery,Iowa,19137,-95.16464615,41.03533936,12076,28.48,4955,5689,6387,12038,5,11,12,10,52,730,2244,6465,2637,5363,408,3555,1400,35200,184
IA SD,Muscatine,Iowa,19139,-91.07506561,41.46524811,39907,90.29,14806,19515,20392,37745,208,90,300,1564,2900,2942,8198,23430,5337,16044,1238,10662,4144,50600,262
IA SD,Page,Iowa,19145,-95.15882111,40.74296761,16870,31.53,6687,8173,8697,16586,84,52,80,68,197,999,3215,9122,3534,7339,652,4719,1968,33700,173
IA SD,Polk,Iowa,19153,-93.57466888,41.6783371,327140,562.1,129237,155893,171247,303168,14799,922,6003,2248,6161,24860,57111,207486,37683,135979,6742,84307,44930,59700,369
IA SD,Pottawattamie,Iowa,19155,-95.58707428,41.336483,82628,86.7,31262,39715,42913,81205,464,240,284,435,1516,6191,16336,49045,11056,32831,1569,22226,9036,46900,299
IA SD,Poweshiek,Iowa,19157,-92.5351944,41.6862545,19033,32.54,7158,9158,9875,18705,87,22,191,28,68,1167,3496,11182,3188,8199,1041,5045,2113,47500,232
IA SD,Ringgold,Iowa,19159,-94.25089645,40.73708153,5420,10.13,2218,2578,2842,5390,1,10,18,1,16,290,1008,2809,1313,2713,495,1672,546,22000,155
IA SD,Scott,Iowa,19163,-90.6138382,41.61218071,150979,328.93,57438,73092,77887,139408,7970,485,1357,1759,4253,11758,30429,91464,17328,61379,3941,38115,19323,54400,286
IA SD,Shelby,Iowa,19165,-95.30657578,41.6834774,13230,22.39,5024,6461,6769,13177,5,20,20,8,44,889,2697,6951,2693,5430,406,3709,1315,36500,176
IA SD,Story,Iowa,19169,-93.46866226,42.03445435,74252,129.36,25941,38423,35829,69143,1191,106,3464,348,840,4383,10297,52407,7165,26847,906,14515,11426,63900,334
IA SD,Taylor,Iowa,19173,-94.70981598,40.74079514,7114,13.25,2859,3367,3747,7070,1,7,18,18,46,434,1388,3576,1716,3307,448,2160,699,23000,157
IA SD,Union,Iowa,19175,-94.24938202,41.03150368,12750,29.93,5173,5989,6761,12650,10,22,49,19,42,798,2494,6994,2464,5622,449,3555,1618,32900,213
IA SD,Van Buren,Iowa,19177,-91.95435715,40.7474823,7676,15.86,3056,3781,3895,7638,10,8,18,2,29,547,1468,4093,1568,3529,473,2375,681,21300,143
IA SD,Wapello,Iowa,19179,-92.41362,41.03132629,35687,82.23,14555,17039,18648,35063,270,95,168,91,224,2333,6235,20444,6675,15640,1085,10997,3558,27000,219
IA SD,Warren,Iowa,19181,-93.56452942,41.3352375,36033,62.88,12659,17545,18488,35684,90,51,145,63,277,2596,7590,21902,3945,13157,498,9728,2931,59300,287
IA SD,Washington,Iowa,19183,-91.71320724,41.33566856,19612,34.41,7454,9441,10171,19403,90,16,54,49,196,1449,3805,10717,3641,7866,412,5349,2105,43000,215
IA SD,Wayne,Iowa,19185,-93.3309288,40.74069214,7067,13.44,2953,3334,3733,7036,1,8,16,6,29,448,1209,3554,1856,3334,381,2237,716,19900,137
ID D,Ada,Idaho,16001,-116.2370224,43.45218468,205775,195.6,77471,101227,104548,198888,958,1382,2887,1660,5556,15818,42425,126081,21451,80849,3378,53538,23933,70500,340
ID D,Adams,Idaho,16003,-116.4949379,44.85076714,3254,2.39,1251,1677,1577,3203,2,41,1,7,38,240,685,1854,475,1778,527,942,309,43900,180
ID D,Bannock,Idaho,16005,-112.3044128,42.63928986,66026,59.38,23412,32739,33287,61742,431,1678,712,1463,2740,5570,15912,37859,6685,25694,2282,16082,7330,53300,237
ID D,Bear Lake,Idaho,16007,-111.3394013,42.29828262,6084,6.15,2005,3003,3081,5999,0,25,5,55,136,542,1735,2892,915,2934,929,1668,337,38700,175
ID D,Benewah,Idaho,16009,-116.6844978,47.21430969,7937,10.12,2991,4025,3912,7278,6,602,28,23,124,595,1752,4549,1041,3731,740,2284,707,44500,172
ID D,Bingham,Idaho,16011,-112.2882156,43.23703957,37583,17.93,11513,18850,18733,32439,39,2615,273,2217,3614,3548,10974,19292,3769,12664,1151,8830,2683,50700,207
ID D,Blaine,Idaho,16013,-113.9893265,43.29761124,13552,5.15,5506,7039,6513,13241,10,53,104,144,397,1021,2584,9051,896,9500,3994,3534,1972,127400,410
ID D,Boise,Idaho,16015,-115.6160774,43.96042252,3509,1.85,1357,1849,1660,3431,2,35,14,27,84,247,746,2132,384,2894,1537,1075,282,59700,201
ID D,Bonner,Idaho,16017,-116.5451584,48.36194801,26622,15.42,10269,13231,13391,26210,37,220,71,84,352,1872,5721,15217,3812,15152,4883,7780,2489,60500,251
ID D,Bonneville,Idaho,16019,-111.7771645,43.321064,72207,39.24,24289,36330,35877,69246,297,391,687,1586,3010,6828,18557,40340,6482,26049,1760,17371,6918,63700,293
ID D,Boundary,Idaho,16021,-116.5433273,48.7481041,8332,6.57,2857,4252,4080,7950,3,150,26,203,310,635,2065,4610,1022,3242,385,2237,620,49500,217
ID D,Butte,Idaho,16023,-113.2332649,43.75344276,2918,1.31,997,1471,1447,2829,0,22,5,62,101,217,807,1519,375,1265,268,744,253,41400,158
ID D,Camas,Idaho,16025,-114.7187996,43.5255127,727,0.68,275,388,339,712,2,8,3,2,4,57,159,412,99,481,206,208,67,35500,171
ID D,Canyon,Idaho,16027,-116.7494431,43.57814407,90076,154.24,31288,44374,45702,80445,175,687,987,7782,11838,7430,20282,50020,12344,33137,1849,21493,9795,51900,232
ID D,Caribou,Idaho,16029,-111.5937614,42.71781158,6963,3.95,2262,3496,3467,6824,7,22,13,97,192,566,2079,3504,814,2867,605,1813,449,48200,190
ID D,Cassia,Idaho,16031,-113.6287041,42.33082962,19532,7.63,6373,9823,9709,17580,3,170,96,1683,2623,1794,5350,9965,2423,7212,839,4550,1823,46100,193
ID D,Clark,Idaho,16033,-112.2932243,44.26366043,762,0.43,277,418,344,688,0,5,0,69,79,53,179,437,93,502,225,174,103,37300,189
ID D,Clearwater,Idaho,16035,-115.5359001,46.59464455,8505,3.8,3213,4439,4066,8262,10,180,21,32,112,448,1699,5077,1281,3805,592,2388,825,43000,194
ID D,Custer,Idaho,16037,-114.2996254,44.2119503,4133,0.84,1561,2131,2002,4044,2,33,19,35,90,331,930,2374,498,2437,876,1108,453,49800,219
ID D,Elmore,Idaho,16039,-115.6084557,43.42494965,21205,6.9,7136,11070,10135,18898,777,171,453,906,1597,2229,4450,12932,1594,8430,1294,3883,3253,57900,242
ID D,Franklin,Idaho,16041,-111.8047676,42.21341705,9232,13.9,2824,4640,4592,9052,5,38,12,125,237,863,2806,4279,1284,3240,416,2264,560,46800,192
ID D,Fremont,Idaho,16043,-111.5971298,44.3131218,10937,5.91,3453,5562,5375,10273,9,68,37,550,762,951,3189,5559,1238,5961,2508,2769,684,46200,192
ID D,Gem,Idaho,16045,-116.278423,44.14737701,11844,21.23,4424,5908,5936,11322,13,139,53,317,615,843,2494,6389,2118,4725,301,3438,986,46700,192
ID D,Gooding,Idaho,16047,-114.8273277,42.91436386,11633,15.98,4320,5807,5826,10886,7,43,31,666,1021,853,2666,6103,2011,4800,480,3021,1299,40600,180
ID D,Idaho,Idaho,16049,-115.5570259,45.88208199,13783,1.62,5187,7002,6781,13378,3,346,34,22,124,908,2937,7788,2150,6346,1159,3916,1271,45700,188
ID D,Jefferson,Idaho,16051,-112.149437,43.83391571,16543,15.14,4871,8400,8143,15627,7,122,40,747,1155,1652,5031,8238,1622,5353,482,3920,951,54300,221
ID D,Jerome,Idaho,16053,-114.2655754,42.67277336,15138,25.19,5325,7567,7571,14304,9,115,54,656,1018,1239,3618,8146,2135,5886,561,3751,1574,42100,189
ID D,Kootenai,Idaho,16055,-116.6837616,47.67436218,69795,56.29,26942,34267,35528,68461,94,675,326,239,1052,4955,13986,41499,9355,31964,5022,19208,7734,64800,296
ID D,Latah,Idaho,16057,-116.6843033,46.8267746,30617,28.43,11229,15610,15007,29388,174,206,709,140,449,1990,5011,20661,2955,11870,641,6330,4899,63500,264
ID D,Lemhi,Idaho,16059,-113.8064652,44.95876312,6899,1.51,2769,3423,3476,6773,2,49,23,52,140,479,1419,3796,1205,3752,983,2038,731,47500,196
ID D,Lewis,Idaho,16061,-116.3598709,46.22589684,3516,7.36,1393,1786,1730,3322,4,169,18,3,42,260,730,1912,614,1681,288,992,401,38500,164
ID D,Lincoln,Idaho,16063,-114.1454163,42.97827339,3308,2.75,1191,1683,1625,3231,3,22,12,40,195,235,804,1791,478,1386,195,857,334,37000,171
ID D,Madison,Idaho,16065,-111.6778145,43.77061462,23674,50.59,5801,11219,12455,22741,43,108,296,486,753,1920,5710,14678,1366,6133,332,3476,2325,68700,239
ID D,Minidoka,Idaho,16067,-113.6647606,42.8539505,19361,25.58,6472,9719,9642,16540,43,201,100,2477,3735,1618,5172,10159,2412,7044,572,4820,1652,41400,184
ID D,Nez Perce,Idaho,16069,-116.7120285,46.23392487,33754,39.95,13618,16562,17192,31681,48,1692,211,122,419,2179,6226,19927,5422,14463,845,9020,4598,56700,249
ID D,Oneida,Idaho,16071,-112.5291405,42.25033951,3492,2.91,1159,1735,1757,3431,4,19,8,30,56,330,968,1576,618,1496,337,948,211,43100,201
ID D,Owyhee,Idaho,16073,-116.0246429,42.8369236,8392,1.1,2820,4384,4008,6935,22,276,76,1083,1408,703,2072,4544,1073,3332,512,1928,892,39900,172
ID D,Payette,Idaho,16075,-116.7086182,43.96483612,16434,40.58,6040,8081,8353,15210,14,189,158,863,1200,1302,3693,8802,2637,6520,480,4282,1758,43800,208
ID D,Power,Idaho,16077,-112.8049889,42.71513557,7086,5.05,2370,3522,3564,6157,7,203,40,679,937,601,1881,3880,724,2701,331,1750,620,50400,190
ID D,Shoshone,Idaho,16079,-116.0080511,47.48875237,13931,5.27,5691,6936,6995,13620,16,182,40,73,247,801,2797,8004,2329,6923,1232,4035,1656,32500,169
ID D,Teton,Idaho,16081,-111.2186699,43.7491188,3439,7.68,1123,1811,1628,3360,2,13,1,63,237,333,822,1901,383,1645,522,831,292,59000,229
ID D,Twin Falls,Idaho,16083,-114.514389,42.45482445,53580,27.56,19737,26257,27323,51202,65,309,524,1480,3106,4131,11915,29337,8197,21158,1421,13380,6357,50700,235
ID D,Valley,Idaho,16085,-115.448967,44.67542839,6109,1.66,2404,3113,2996,5988,8,60,27,26,107,419,1285,3624,781,6640,4236,1698,706,70700,265
ID D,Washington,Idaho,16087,-116.7663956,44.48671722,8550,5.88,3257,4130,4420,7660,7,46,130,707,915,587,1889,4369,1705,3685,428,2360,897,43700,183
IL CD,Adams,Illinois,17001,-91.21868896,39.98086548,66090,77.57,25515,31417,34673,63917,1702,98,249,124,265,4636,12407,37445,11602,28021,2506,18147,7368,43400,198
IL CD,Brown,Illinois,17009,-90.71904373,39.97555923,5836,19.07,1991,3287,2549,5264,547,14,5,6,104,325,956,3573,982,2357,366,1468,523,30600,155
IL CD,Bureau,Illinois,17011,-89.51935196,41.36974525,35688,41.07,13790,17056,18632,35157,50,65,195,221,1003,2330,7095,19769,6494,14762,972,10026,3764,41800,220
IL CD,Cass,Illinois,17017,-90.2914772,40.00250626,13437,35.93,5195,6537,6900,13384,16,8,23,6,56,881,2601,7652,2303,5698,503,3847,1348,32900,188
IL CD,Champaign,Illinois,17019,-88.20043564,40.14215088,173025,173.37,63900,87492,85533,146506,16559,331,8033,1596,3485,11847,25919,120130,15129,68416,4516,34857,29043,67700,336
IL CD,Christian,Illinois,17021,-89.28621674,39.58500099,34418,48.48,13591,16241,18177,34176,82,51,89,20,103,2371,6340,19559,6148,14640,1049,10037,3554,37400,200
IL CD,Coles,Illinois,17029,-88.21972656,39.53274345,51644,101.46,18957,24342,27302,50177,925,92,341,109,405,2849,7857,33838,7100,20329,1372,12256,6701,44600,238
IL CD,De Witt,Illinois,17039,-88.8650322,40.17209053,16516,41.6,6488,8091,8425,16387,25,37,43,24,80,1131,3122,9517,2746,6942,454,4599,1889,43700,203
IL CD,Douglas,Illinois,17041,-88.20879364,39.7674408,19464,46.68,7206,9420,10044,19280,16,19,41,108,292,1414,4074,11006,2970,7607,401,5371,1835,44000,217
IL CD,Edgar,Illinois,17045,-87.7533493,39.68303871,19595,31.45,7859,9290,10305,19469,68,24,24,10,52,1246,3761,10868,3720,8733,874,5724,2135,33200,187
IL CD,Ford,Illinois,17053,-88.2014389,40.70226288,14275,29.37,5602,6828,7447,14157,43,14,40,21,81,941,2749,7859,2726,6118,516,4105,1497,42500,213
IL CD,Fulton,Illinois,17057,-90.16255569,40.45462799,38080,43.72,14893,18690,19390,37117,668,83,105,107,244,2210,7094,21551,7225,16480,1587,10746,4147,31100,189
IL CD,Greene,Illinois,17061,-90.38761139,39.32157898,15317,28.21,5910,7441,7876,15231,14,50,17,5,44,1063,2996,8358,2900,6575,665,4385,1525,29000,157
IL CD,Grundy,Illinois,17063,-88.42490387,41.28868484,32337,76.45,11979,16028,16309,31864,21,45,113,294,748,2349,6587,19230,4171,12652,673,8364,3615,71900,319
IL CD,Hancock,Illinois,17067,-91.20983887,40.42021942,21373,26.85,8409,10155,11218,21272,26,25,37,13,58,1336,4150,11889,3998,9692,1283,6407,2002,34500,175
IL CD,Henderson,Illinois,17071,-91.002491,40.85434151,8096,21.71,3237,3957,4139,8037,8,29,10,12,56,512,1558,4704,1322,4089,852,2471,766,32900,176
IL CD,Henry,Illinois,17073,-90.1521225,41.36814499,51159,62.09,19514,24971,26188,49969,657,63,128,342,797,3412,10343,29033,8371,20881,1367,14654,4860,40500,217
IL CD,Iroquois,Illinois,17075,-87.8316803,40.74736023,30787,27.54,11788,14914,15873,30154,164,43,69,357,660,2013,5958,17182,5634,12819,1031,8699,3089,40100,202
IL CD,Jo Daviess,Illinois,17085,-90.28704834,42.35334015,21821,36.19,8371,10748,11073,21732,14,20,29,26,94,1386,4330,12463,3642,10757,2386,6274,2097,48700,212
IL CD,Kankakee,Illinois,17091,-87.89386749,41.15198326,96255,141.76,34623,46564,49691,80194,14399,150,644,868,1946,7302,19788,55974,13191,37001,2378,23126,11497,54700,273
IL CD,Knox,Illinois,17095,-90.22000122,40.93270111,56393,78.32,21909,27631,28762,52413,2860,85,320,715,1416,3398,10082,33254,9659,23722,1813,15147,6762,37100,215
IL CD,Livingston,Illinois,17105,-88.5888176,40.86822701,39301,37.57,13737,19719,19582,36551,2115,62,131,442,826,2610,7201,23278,6212,14365,628,9737,4000,46700,238
IL CD,Logan,Illinois,17107,-89.38098526,40.12380409,30798,49.75,11033,15439,15359,29223,1291,37,143,104,348,1958,5374,18530,4936,11638,605,7476,3557,48700,223
IL CD,Macon,Illinois,17115,-88.98677063,39.8575592,117206,201.73,45996,55852,61354,102197,14135,157,506,211,540,8003,22404,69717,17082,50049,4053,32268,13728,45400,250
IL CD,Macoupin,Illinois,17117,-89.92863464,39.26241684,47679,55.12,18176,22816,24863,47077,379,94,88,41,184,3061,9270,26748,8600,20068,1892,14064,4112,39700,194
IL CD,Marshall,Illinois,17123,-89.35348511,41.0377636,12846,33.11,4900,6197,6649,12752,17,30,28,19,79,758,2476,7114,2498,5317,417,3729,1171,44000,196
IL CD,Mason,Illinois,17125,-89.97992706,40.25012016,16269,30.35,6342,7922,8347,16180,8,27,38,16,58,1075,3160,9187,2847,7684,1342,4681,1661,35800,185
IL CD,McDonough,Illinois,17109,-90.68479919,40.45783043,35244,59.74,12255,17507,17737,32992,1254,65,802,131,358,1750,4737,23914,4843,13257,1002,7621,4634,36000,223
IL CD,McLean,Illinois,17113,-88.86906815,40.52020264,129180,109.01,46796,61635,67545,121057,5563,203,1624,733,1671,8557,21265,85905,13453,49164,2368,29696,17100,65900,326
IL CD,Menard,Illinois,17129,-89.79069901,40.03564072,11164,35.44,4199,5374,5790,11101,9,29,14,11,37,770,2297,6416,1681,4650,451,3218,981,51500,210
IL CD,Mercer,Illinois,17131,-90.77000809,41.20071602,17290,30.93,6572,8390,8900,17155,30,33,35,37,109,1137,3466,9894,2793,7244,672,4910,1662,34900,189
IL CD,Montgomery,Illinois,17135,-89.42475128,39.262537,30728,43.59,11480,15294,15434,29956,559,49,66,98,235,2042,5779,17302,5605,12456,976,8795,2685,35300,182
IL CD,Morgan,Illinois,17137,-90.26878738,39.70272827,36397,64.08,13678,17692,18705,34561,1510,48,130,148,286,2286,6583,21777,5751,14724,1046,9256,4422,47700,231
IL CD,Moultrie,Illinois,17139,-88.64412689,39.62288857,13930,42.86,5122,6627,7303,13884,8,22,13,3,38,960,2702,7590,2678,5384,262,3884,1238,41200,210
IL CD,Peoria,Illinois,17143,-89.72367477,40.74675369,182827,294.41,70797,87511,95316,154298,24892,312,2225,1100,2596,12831,34674,109334,25988,75211,4414,45311,25486,49100,272
IL CD,Piatt,Illinois,17147,-88.60982513,40.03966141,15548,35.42,5934,7570,7978,15508,8,16,11,5,35,964,3025,9163,2396,6227,293,4539,1395,51200,232
IL CD,Pike,Illinois,17149,-90.97523117,39.62028313,17577,21.18,7016,8457,9120,17499,8,24,32,14,69,1125,3240,9589,3623,8057,1041,5169,1847,28500,144
IL CD,Putnam,Illinois,17155,-89.31982422,41.21349525,5730,35.81,2204,2877,2853,5616,9,7,7,91,138,394,1104,3349,883,2600,396,1707,497,48400,199
IL CD,Rock Island,Illinois,17161,-90.30939636,41.5568943,148723,351.59,59317,71519,77204,133428,10488,354,1017,3436,8084,10292,27617,88610,22204,63327,4010,39664,19653,47800,253
IL CD,Sangamon,Illinois,17167,-89.61069489,39.75359726,178386,205.99,72146,83971,94415,162013,14364,290,1377,342,1274,12840,32711,108385,24450,76873,4727,47994,24152,60900,310
IL CD,Schuyler,Illinois,17169,-90.56538391,40.13406181,7498,17.2,3002,3651,3847,7479,2,9,6,2,7,451,1408,4187,1452,3329,327,2281,721,35100,183
IL CD,Scott,Illinois,17171,-90.47353363,39.65932846,5644,22.49,2190,2698,2946,5634,1,6,3,0,15,367,1112,3156,1009,2442,252,1619,571,32800,148
IL CD,Shelby,Illinois,17173,-88.80703354,39.43476105,22261,29.8,8563,10955,11306,22190,14,27,27,3,45,1516,4235,12517,3993,9329,766,6757,1806,39100,188
IL CD,Stark,Illinois,17175,-89.81785202,41.1076107,6534,22.69,2512,3135,3399,6496,8,8,21,1,30,408,1272,3586,1268,2716,204,1865,647,31200,184
IL CD,Tazewell,Illinois,17179,-89.5998497,40.53535652,123692,190.3,47171,59949,63743,122639,186,221,432,214,825,8416,24283,74622,16371,49315,2144,33757,13414,48700,243
IL CD,Vermilion,Illinois,17183,-87.74103928,40.18503952,88257,98.06,34072,42986,45271,78956,7841,165,507,788,1405,5920,16948,51398,13991,37061,2989,24269,9803,38700,223
IL CD,Warren,Illinois,17187,-90.62186813,40.84928513,19181,35.32,7393,9252,9929,18630,356,20,70,105,207,1236,3738,10892,3315,8229,836,5130,2263,33700,197
IL CD,Woodford,Illinois,17203,-89.24733734,40.76468658,32653,61.96,11395,15955,16698,32388,64,54,102,45,221,2358,7078,18626,4591,11932,537,8924,2471,57700,244
IL ND,Boone,Illinois,17007,-88.82477951,42.32165718,30806,109.24,10950,15224,15582,29344,127,46,150,1139,2065,2349,6258,18613,3586,11477,527,7918,3032,67900,306
IL ND,Carroll,Illinois,17015,-90.00741959,42.06410599,16805,37.85,6638,8129,8676,16519,111,30,61,84,296,1075,3148,9443,3139,7481,843,4767,1871,38300,196
IL ND,Cook,Illinois,17031,-87.89929199,41.81256676,5105067,5328.88,1879488,2455036,2650031,3204947,1317147,10289,188565,384119,694194,380591,899454,3191790,633232,2021833,142345,1042904,836584,102100,411
IL ND,De Kalb,Illinois,17037,-88.77041245,41.89282036,77932,122.92,26413,38312,39620,72968,2069,123,1751,1021,2329,4913,11769,53260,7990,27351,938,15351,11062,81200,354
IL ND,Du Page,Illinois,17043,-88.09466553,41.84627533,781666,2319.48,279344,385520,396146,714905,15462,962,39634,10703,34567,63817,142599,507266,67984,292537,13193,207956,71388,137100,568
IL ND,Kane,Illinois,17089,-88.42572403,41.93853378,317471,605.86,107176,157573,159898,269675,19006,620,4474,23696,43535,27799,66726,193385,29561,111496,4320,74514,32662,102500,439
IL ND,Kendall,Illinois,17093,-88.43673325,41.59104347,39413,122.4,13301,19721,19692,38019,210,73,224,887,1805,3017,8776,24184,3436,13747,446,10231,3070,99700,416
IL ND,La Salle,Illinois,17099,-88.8824234,41.2823391,106913,93.87,41284,52236,54677,103805,1153,206,523,1226,3249,7245,19949,61266,18453,43827,2543,30224,11060,50500,236
IL ND,Lake,Illinois,17097,-87.98213196,42.32303429,516418,1137.48,173966,261305,255113,450666,34771,1198,12588,17195,38570,43849,98623,330524,43422,183283,9317,129036,44930,136700,487
IL ND,Lee,Illinois,17103,-89.28896713,41.74896431,34392,47.44,12475,17325,17067,32530,1222,84,181,375,727,2377,6538,20416,5061,13314,839,8682,3793,46600,228
IL ND,McHenry,Illinois,17111,-88.45251083,42.32362938,183241,302.38,62940,91558,91683,178895,310,299,1293,2444,6066,15798,37474,112630,17339,65985,3045,50289,12651,111000,461
IL ND,Ogle,Illinois,17141,-89.31843185,42.04463387,45957,60.55,17132,22504,23453,44895,66,87,136,773,1379,3357,9242,26900,6458,18052,920,12202,4930,57200,252
IL ND,Stephenson,Illinois,17177,-89.66203308,42.35058784,48052,85.2,18920,23204,24848,44524,3081,58,304,85,283,3416,8975,27982,7679,20378,1458,13469,5451,50700,231
IL ND,Whiteside,Illinois,17195,-89.94517899,41.75866508,60186,88.25,22740,29335,30851,57135,417,85,187,2362,4462,4186,11972,35082,8946,24000,1260,16312,6428,44400,240
IL ND,Will,Illinois,17197,-87.89960098,41.46669388,357313,423.36,116933,178351,178962,303420,38361,692,4774,10066,19973,29446,77001,220027,30839,122870,5937,90488,26445,89900,377
IL ND,Winnebago,Illinois,17201,-89.17030716,42.3246479,252913,490.14,96727,122615,130298,222439,23256,651,2986,3581,7771,19215,47089,154561,32048,101666,4939,65807,30920,60600,301
IL SD,Alexander,Illinois,17003,-89.32187271,37.16308975,10626,45.03,4234,4991,5635,7054,3496,19,48,9,54,895,2170,5638,1923,4902,668,2895,1339,23900,124
IL SD,Bond,Illinois,17005,-89.45084381,38.88474846,14991,39.76,5652,7247,7744,14477,429,35,16,34,80,946,2735,8695,2615,6136,484,4397,1255,40400,180
IL SD,Calhoun,Illinois,17013,-90.70886612,39.13595581,5322,21.29,2048,2660,2662,5298,1,8,15,0,12,330,961,2970,1061,2951,903,1643,405,35000,143
IL SD,Clark,Illinois,17023,-87.77630997,39.32842064,15921,31.46,6394,7646,8275,15842,10,26,36,7,42,1037,2879,8915,3090,7115,721,5002,1392,34200,167
IL SD,Clay,Illinois,17025,-88.4821167,38.76234818,14460,30.83,5708,6838,7622,14403,4,17,29,7,57,904,2774,7982,2800,6270,562,4504,1204,31900,162
IL SD,Clinton,Illinois,17027,-89.42967606,38.58046341,33944,71.92,11583,17294,16650,32688,1021,48,104,83,336,2358,6807,20144,4635,12746,1163,9205,2378,55000,218
IL SD,Crawford,Illinois,17033,-87.74291611,39.01688385,19464,43.64,7792,9408,10056,19300,63,34,48,19,80,1247,3576,11080,3561,8464,672,6107,1685,36700,190
IL SD,Cumberland,Illinois,17035,-88.24152374,39.2768631,10670,30.84,4029,5259,5411,10627,5,6,26,6,39,805,2185,6011,1669,4448,419,3253,776,37700,169
IL SD,Edwards,Illinois,17047,-88.05172729,38.41782379,7440,33.36,3016,3566,3874,7401,6,8,19,6,30,466,1364,4133,1477,3260,244,2449,567,32000,158
IL SD,Effingham,Illinois,17049,-88.58726501,39.06480026,31704,66.33,11465,15450,16254,31523,12,45,95,29,121,2761,6798,17733,4412,12189,724,8767,2698,54400,214
IL SD,Fayette,Illinois,17051,-88.98298264,38.97900772,20893,29.47,7719,10615,10278,20148,599,40,35,71,154,1341,3872,11944,3736,8551,832,5965,1754,34600,175
IL SD,Franklin,Illinois,17055,-88.94371796,37.99741554,40319,97.39,16564,19112,21207,40068,36,106,84,25,110,2474,7209,22494,8142,18430,1866,12657,3907,30000,184
IL SD,Gallatin,Illinois,17059,-88.20592117,37.75193787,6909,21.26,2784,3301,3608,6842,42,10,11,4,16,409,1229,3916,1355,3197,413,2194,590,32600,124
IL SD,Hamilton,Illinois,17065,-88.54129791,38.08476067,8499,19.49,3476,4025,4474,8462,3,11,21,2,29,502,1541,4610,1846,4013,537,2760,716,29400,139
IL SD,Hardin,Illinois,17069,-88.24570847,37.51048088,5189,28.67,2049,2604,2585,5062,85,16,13,13,30,278,953,3046,912,2403,354,1606,443,25100,131
IL SD,Jackson,Illinois,17077,-89.42212677,37.76208305,61067,103.5,23466,31396,29671,51991,6342,109,2178,447,1082,3362,8238,42892,6575,25539,2073,12377,11089,47100,249
IL SD,Jasper,Illinois,17079,-88.16042328,39.01582527,10609,21.39,3962,5184,5425,10574,1,11,17,6,32,772,2226,5744,1867,4297,335,3274,688,39400,162
IL SD,Jefferson,Illinois,17081,-88.92770767,38.30094337,37020,64.95,14606,17755,19265,34856,1924,56,129,55,157,2728,7219,20970,6103,16075,1469,10665,3941,41500,197
IL SD,Jersey,Illinois,17083,-90.38150024,39.09143257,20539,55.06,7344,10034,10505,20346,96,43,32,22,103,1418,4090,12198,2833,8216,872,5587,1757,45400,209
IL SD,Johnson,Illinois,17087,-88.88138199,37.45286369,11347,32.79,3725,6564,4783,10230,1046,26,14,31,189,544,1704,7346,1753,4671,946,3043,682,36800,150
IL SD,Lawrence,Illinois,17101,-87.71273041,38.71588135,15972,42.71,6320,7476,8496,15759,151,31,21,10,56,963,2832,8836,3341,6980,660,4834,1486,32800,172
IL SD,Madison,Illinois,17119,-89.94171524,38.8278656,249238,342.36,94857,119565,129673,230217,16136,683,1420,782,2713,17914,45834,150899,34591,101098,6241,68330,26527,51400,282
IL SD,Marion,Illinois,17121,-88.92372513,38.65219879,41561,72.53,16272,19777,21784,39647,1519,106,232,57,232,2924,8155,23401,7081,18123,1851,12403,3869,36000,189
IL SD,Massac,Illinois,17127,-88.71160126,37.20286179,14752,61.21,5908,6928,7824,13804,870,37,31,10,44,850,2653,8399,2850,6446,538,4582,1326,35700,157
IL SD,Monroe,Illinois,17133,-90.13677216,38.30379677,22422,57.79,8189,11028,11394,22262,13,53,57,37,166,1648,4342,13425,3007,8774,585,6433,1756,72100,295
IL SD,Perry,Illinois,17145,-89.36306763,38.08301163,21412,48.33,8306,10293,11119,20901,399,26,63,23,120,1458,4190,12113,3651,9235,929,6484,1822,40400,173
IL SD,Pope,Illinois,17151,-88.56348419,37.33804131,4373,11.69,1611,2340,2033,4072,266,15,6,14,57,221,787,2559,806,2154,543,1217,394,29700,121
IL SD,Pulaski,Illinois,17153,-89.0993042,37.20101357,7523,37.06,2957,3508,4015,5032,2466,8,7,10,29,544,1628,3936,1415,3410,453,2242,715,24000,133
IL SD,Randolph,Illinois,17157,-89.9023819,38.01412964,34583,59.32,11949,18425,16158,31532,2852,54,83,62,345,2108,6286,20889,5300,13179,1230,9379,2570,45000,202
IL SD,Richland,Illinois,17159,-88.10526657,38.71512794,16545,45.96,6503,7897,8648,16442,17,24,43,19,74,1124,3178,9357,2886,7142,639,4981,1522,35800,180
IL SD,Saline,Illinois,17165,-88.54466248,37.75961685,26551,68.96,10839,12520,14031,25452,931,66,40,62,135,1608,4800,14735,5408,12350,1511,8148,2691,33400,173
IL SD,St. Clair,Illinois,17163,-89.98773575,38.43889809,262852,391.15,95333,125531,137321,187866,71275,585,2007,1119,3861,20989,53820,154710,33333,103432,8099,61674,33659,55500,285
IL SD,Union,Illinois,17181,-89.28564453,37.47181129,17619,42.56,6838,8576,9043,17313,122,34,53,97,182,1082,3005,10199,3333,7408,570,4938,1900,36700,168
IL SD,Wabash,Illinois,17185,-87.81990814,38.40821838,13111,58.53,5032,6291,6820,12955,40,11,80,25,73,849,2561,7583,2118,5572,540,3814,1218,42200,187
IL SD,Washington,Illinois,17189,-89.42938232,38.36327934,14965,26.58,5658,7285,7680,14856,46,31,26,6,48,1004,2927,8249,2785,6261,603,4539,1119,46000,206
IL SD,Wayne,Illinois,17191,-88.42778397,38.43403053,17241,24.11,6935,8285,8956,17141,9,31,44,16,72,1092,3134,9649,3366,7622,687,5487,1448,34500,157
IL SD,White,Illinois,17193,-88.15422821,38.07753944,16522,33.24,6845,7778,8744,16397,41,37,35,12,58,1006,2902,9198,3416,7797,952,5121,1724,34500,158
IL SD,Williamson,Illinois,17199,-88.93218613,37.73525047,57733,135.21,23120,27783,29950,56135,1147,112,252,87,448,3693,10142,34124,9774,25183,2063,17045,6075,40800,210
IN ND,Adams,Indiana,18001,-84.93457413,40.76313782,31095,91.46,10470,15233,15862,30530,36,42,60,427,810,2698,7162,17061,4174,10931,461,8206,2264,51100,229
IN ND,Allen,Indiana,18003,-85.06748581,41.10557365,300836,456.5,113333,145796,155040,264086,30314,892,2644,2900,5821,23860,59644,183208,34124,122923,9590,79567,33766,59900,320
IN ND,Benton,Indiana,18007,-87.31872559,40.61308479,9441,23.2,3524,4618,4823,9389,6,16,1,29,108,696,1962,5211,1572,3833,309,2569,955,38100,196
IN ND,Blackford,Indiana,18009,-85.32418823,40.4913578,14067,84.74,5436,6827,7240,13978,7,44,16,22,90,973,2599,8352,2143,5856,420,4202,1234,32300,181
IN ND,Carroll,Indiana,18015,-86.57478333,40.59176254,18809,50.56,7067,9213,9596,18720,19,22,3,45,121,1312,3664,11047,2786,8431,1364,5515,1552,45400,210
IN ND,Cass,Indiana,18017,-86.37525177,40.74796486,38413,92.79,14659,18444,19969,37765,330,138,114,66,230,2592,7565,22398,5858,15633,974,10899,3760,40300,219
IN ND,De Kalb,Indiana,18033,-84.99409485,41.40782547,35324,97.04,12725,17311,18013,35009,37,91,88,99,321,2727,7498,20877,4222,13601,876,10333,2392,49700,259
IN ND,Elkhart,Indiana,18039,-85.86388397,41.60225296,156198,335.19,56713,76391,79807,146505,7106,453,997,1137,2932,13277,31200,94224,17497,60182,3469,40745,15968,62300,335
IN ND,Fulton,Indiana,18049,-86.21379089,41.04633331,18840,51.06,7345,9153,9687,18555,151,47,36,51,135,1290,3726,10815,3009,8656,1311,5681,1664,42200,225
IN ND,Grant,Indiana,18053,-85.65558243,40.53241348,74169,178.72,27701,35704,38465,67817,5047,298,373,634,1514,4809,13561,45572,10227,29904,2203,19758,7943,40400,231
IN ND,Huntington,Indiana,18069,-85.49220657,40.8404026,35427,96.8,12830,17168,18259,35012,52,154,133,76,281,2653,7151,20569,5054,13629,799,9840,2990,44200,266
IN ND,Jasper,Indiana,18073,-87.10617828,41.01437569,24960,44.49,8527,12353,12607,24659,111,60,40,90,317,1772,5401,14718,3069,8984,457,6428,2099,55100,228
IN ND,Jay,Indiana,18075,-85.00404358,40.45215607,21512,56.02,8161,10450,11062,21313,30,32,67,70,151,1504,4196,12508,3304,8905,744,6330,1831,32400,181
IN ND,Kosciusko,Indiana,18085,-85.87158585,41.24828911,65294,120.91,23449,31986,33308,64058,309,118,322,487,1258,5342,13432,38777,7743,30516,7067,18529,4920,60600,280
IN ND,La Porte,Indiana,18091,-86.71406555,41.50269318,107066,178.44,38488,54483,52583,96286,9580,259,431,510,1576,7145,19968,65923,14030,42268,3780,28132,10356,52700,266
IN ND,Lagrange,Indiana,18087,-85.42822647,41.6495266,29477,77.57,9209,14710,14767,29156,44,59,92,126,362,2934,7408,16126,3009,12218,3009,7496,1713,55100,244
IN ND,Lake,Indiana,18089,-87.38180161,41.44867325,475594,949.29,170748,228069,247525,334203,116688,865,2772,21066,44526,34039,99128,283748,58679,183014,12266,115720,55028,54800,287
IN ND,Marshall,Indiana,18099,-86.27074051,41.33117104,42182,95,15146,20710,21472,41508,76,72,151,375,830,3255,8773,24507,5647,16820,1674,11619,3527,49600,263
IN ND,Miami,Indiana,18103,-86.01812363,40.79402542,36897,99.99,13484,18174,18723,34784,1115,571,224,203,544,2911,7573,22123,4290,14639,1155,9516,3968,40300,238
IN ND,Newton,Indiana,18111,-87.39921188,40.9825573,13551,33.79,4839,6664,6887,13436,9,39,24,43,177,950,2974,7826,1801,5276,437,3723,1116,43300,207
IN ND,Noble,Indiana,18113,-85.42955399,41.40682411,37877,91.71,13418,18664,19213,37456,58,83,98,182,625,3067,8046,22187,4577,15516,2098,10485,2933,49100,253
IN ND,Porter,Indiana,18127,-87.08459091,41.4703064,128932,308.45,45159,63044,65888,126329,454,243,944,962,3858,8705,26818,80711,12698,47240,2081,33963,11196,69600,340
IN ND,Pulaski,Indiana,18131,-86.70298386,41.04550552,12643,29.06,4722,6227,6416,12509,65,21,20,28,106,956,2663,7047,1977,5541,819,3661,1061,40300,198
IN ND,St. Joseph,Indiana,18141,-86.29934692,41.60272598,247052,538.24,92365,119057,127995,216984,24190,846,2507,2525,5201,17958,44505,149710,34879,97956,5591,66492,25873,50800,325
IN ND,Starke,Indiana,18149,-86.70423889,41.30836868,22747,73.61,8141,11201,11546,22446,73,86,48,94,367,1667,4713,13090,3277,9888,1747,6344,1797,40900,204
IN ND,Steuben,Indiana,18151,-84.99284744,41.64662933,27446,89.11,10194,13701,13745,27146,51,64,132,53,193,1987,5189,16681,3589,15768,5574,8053,2141,59800,271
IN ND,Tippecanoe,Indiana,18157,-86.90095901,40.40135956,130598,260.16,45618,66206,64392,122013,2660,320,4821,784,2078,8203,19181,90895,12319,48134,2516,26059,19559,66000,335
IN ND,Wabash,Indiana,18169,-85.7959938,40.85287094,35069,88.11,12630,16972,18097,34462,138,259,123,87,321,2365,6852,20645,5207,13394,764,9380,3250,43400,233
IN ND,Wells,Indiana,18179,-85.26455688,40.75925446,25948,70.13,9438,12592,13356,25758,10,40,41,99,262,2002,5376,15067,3503,9928,490,7443,1995,53000,236
IN ND,White,Indiana,18181,-86.8431778,40.74759483,23265,45.98,8926,11241,12024,23127,2,50,41,45,175,1593,4695,13310,3667,11875,2949,6780,2146,46900,217
IN ND,Whitley,Indiana,18183,-85.50117111,41.15376472,27651,82.29,10010,13573,14078,27473,29,73,37,39,126,2084,5771,16212,3584,10852,842,8259,1751,57300,247
IN SD,Bartholomew,Indiana,18005,-85.89986038,39.18989182,63657,155.64,24192,30921,32736,61774,1005,97,610,171,435,4571,11904,39850,7332,25432,1240,17703,6489,57200,305
IN SD,Boone,Indiana,18011,-86.47708511,40.06112862,38147,90.18,13922,18375,19772,37814,83,90,94,66,250,2852,7585,22823,4887,14516,594,10607,3315,71100,297
IN SD,Brown,Indiana,18013,-86.24285126,39.19064713,14080,45.13,5370,7042,7038,13968,13,47,18,34,94,866,2602,8825,1787,6997,1627,4436,934,64900,278
IN SD,Clark,Indiana,18019,-85.70750427,38.43673515,87777,233.45,33292,41913,45864,82289,4703,192,356,237,560,5765,16784,54633,10595,35313,2021,22760,10532,50000,285
IN SD,Clay,Indiana,18021,-87.10352707,39.38738823,24705,68.63,9382,11849,12856,24522,113,41,15,14,66,1682,4770,14081,4172,10606,1224,7440,1942,35500,197
IN SD,Clinton,Indiana,18023,-86.47232819,40.31439018,30974,76.48,11450,14949,16025,30657,36,51,61,169,453,2295,6257,17617,4805,12100,650,8244,3206,40900,241
IN SD,Crawford,Indiana,18025,-86.463871,38.26179314,9914,32.29,3660,4918,4996,9868,9,26,11,0,16,685,2043,5772,1414,4374,714,3118,542,31800,142
IN SD,Daviess,Indiana,18027,-87.10065079,38.6970005,27533,63.73,10012,13328,14205,27372,99,26,20,16,86,2178,5777,15170,4408,10985,973,7810,2202,40600,188
IN SD,Dearborn,Indiana,18029,-84.9766655,39.12130928,38835,126.5,13642,19026,19809,38440,252,53,75,15,125,2887,8219,23118,4611,14532,890,10683,2959,59900,248
IN SD,Decatur,Indiana,18031,-85.50382614,39.28562737,23645,63.39,8427,11647,11998,23444,39,19,129,14,92,1717,5105,13665,3158,9098,671,6372,2055,44900,227
IN SD,Delaware,Indiana,18035,-85.39753723,40.23843384,119659,305.25,45177,56827,62832,111232,7167,274,641,345,853,7267,19148,78091,15153,48793,3616,30193,14984,42300,254
IN SD,Dubois,Indiana,18037,-86.88259888,38.36389923,36616,85.35,13023,17962,18654,36466,33,30,55,32,244,2950,7344,21805,4517,13964,941,10248,2775,58000,240
IN SD,Fayette,Indiana,18041,-85.17246628,39.64861298,26015,121,9945,12591,13424,25462,435,37,69,12,83,1614,5289,15335,3777,10525,580,6950,2995,41100,225
IN SD,Floyd,Indiana,18043,-85.90003586,38.29512024,64404,429.36,24085,30718,33686,61415,2642,92,175,80,254,4471,12571,39151,8211,25238,1153,17283,6802,57600,267
IN SD,Fountain,Indiana,18045,-87.27088928,40.16772461,17808,44.74,6858,8603,9205,17726,4,25,27,26,88,1201,3411,10227,2969,7344,486,5259,1599,37000,183
IN SD,Franklin,Indiana,18047,-85.05873489,39.39294052,19580,50.86,6636,9693,9887,19496,10,34,27,13,52,1450,4336,11360,2434,7176,540,5275,1361,53300,200
IN SD,Gibson,Indiana,18051,-87.65250397,38.35195351,31913,65.13,12299,15325,16588,31146,596,38,104,29,133,2114,6085,18690,5024,13454,1155,9672,2627,44400,192
IN SD,Greene,Indiana,18055,-86.97681808,39.03552055,30410,55.7,11910,14758,15652,30248,10,47,65,40,146,1942,5787,17693,4988,13337,1427,9578,2332,36800,190
IN SD,Hamilton,Indiana,18057,-86.05859756,40.0805645,108936,273.71,38834,53278,55658,106764,676,163,1190,143,725,8909,22714,68324,8989,41074,2240,29849,8985,106500,412
IN SD,Hancock,Indiana,18059,-85.77248764,39.82518196,45527,148.3,15959,22403,23124,45173,44,59,176,75,333,2992,9553,28234,4748,16495,536,12766,3193,72000,299
IN SD,Harrison,Indiana,18061,-86.1268692,38.19068527,29890,61.5,10618,14817,15073,29641,124,58,36,31,126,2047,6403,18044,3396,11456,838,9060,1558,51800,219
IN SD,Hendricks,Indiana,18063,-86.52354431,39.77095604,75717,185.13,26109,38134,37583,74519,685,157,275,81,353,5312,15800,47254,7351,26962,853,21525,4584,75700,327
IN SD,Henry,Indiana,18065,-85.40317154,39.93527985,48139,122.18,18642,23122,25017,47446,474,78,78,63,214,2951,8886,29187,7115,19835,1193,14024,4618,36800,210
IN SD,Howard,Indiana,18067,-86.12063599,40.48019981,80827,275.86,31523,38634,42193,75420,4398,226,457,326,1057,5768,15774,49813,9472,33820,2297,22716,8807,51700,279
IN SD,Jackson,Indiana,18071,-86.06747055,38.89607239,37730,73.55,14032,18286,19444,37289,138,66,189,48,122,2612,7568,22432,5118,14820,788,10815,3217,43900,237
IN SD,Jefferson,Indiana,18077,-85.44857788,38.75113297,29797,82.09,10897,14525,15272,29181,363,58,122,73,123,1919,5536,18312,4030,11921,1024,7979,2918,44900,215
IN SD,Jennings,Indiana,18079,-85.63074112,39.00106812,23661,62.6,8351,11702,11959,23347,209,31,51,23,90,1658,4728,14542,2733,9129,778,6681,1670,43700,221
IN SD,Johnson,Indiana,18081,-86.11233139,39.486063,88109,274.48,31354,42750,45359,86455,845,139,534,136,627,6230,17587,54936,9356,33289,1935,23206,8148,72200,339
IN SD,Knox,Indiana,18083,-87.43309021,38.66247559,39884,76.7,15145,19392,20492,39107,486,69,178,44,205,2438,6797,24278,6371,16730,1585,10687,4458,39800,226
IN SD,Lawrence,Indiana,18093,-86.49212265,38.83842659,42836,94.77,16235,20752,22084,42536,109,88,77,26,145,2797,8137,25702,6200,17587,1352,12943,3292,42000,222
IN SD,Madison,Indiana,18095,-85.71957779,40.17254257,130669,288.45,49804,63932,66737,119734,9870,299,415,351,885,8402,23973,79962,18332,53353,3549,36395,13409,43700,250
IN SD,Marion,Indiana,18097,-86.14296341,39.78202438,797159,2013.03,319471,378599,418560,615039,169654,1698,7579,3189,8450,63103,140082,501153,92821,349403,29932,182039,137432,61400,345
IN SD,Martin,Indiana,18101,-86.81422424,38.69999504,10369,30.59,3836,5111,5258,10321,12,14,14,8,14,721,2081,6131,1436,4116,280,3133,703,38700,172
IN SD,Monroe,Indiana,18105,-86.51698303,39.16199493,108978,283.06,39351,52650,56328,102752,2835,216,2713,462,1367,5966,14101,79635,9276,41948,2597,21558,17793,66600,339
IN SD,Montgomery,Indiana,18107,-86.90364456,40.05208397,34436,68.19,13235,17097,17339,33971,201,68,138,58,159,2419,6261,20830,4926,13957,722,9555,3680,48100,253
IN SD,Morgan,Indiana,18109,-86.47500992,39.48185158,55920,136.72,19600,27442,28478,55635,9,137,91,48,228,3949,11620,34564,5787,20500,900,15455,4145,59700,287
IN SD,Ohio,Indiana,18115,-84.99079132,38.97058105,5315,61.09,1980,2584,2731,5255,41,8,9,2,7,365,1027,3179,744,2161,181,1557,423,45400,193
IN SD,Orange,Indiana,18117,-86.50284576,38.53827095,18409,45.12,6950,8957,9452,18213,127,40,21,8,59,1289,3633,10689,2798,7732,782,5635,1315,37400,188
IN SD,Owen,Indiana,18119,-86.85417557,39.31384468,17281,44.77,6394,8522,8759,17167,44,46,18,6,55,1210,3415,10348,2308,8011,1617,5307,1087,43000,206
IN SD,Parke,Indiana,18121,-87.22529221,39.78560066,15410,34.71,5845,7477,7933,15222,118,42,16,12,95,1009,2860,9099,2442,7189,1344,4617,1228,37900,193
IN SD,Perry,Indiana,18123,-86.63440323,38.05402184,19107,50.02,6845,9648,9459,18819,210,32,32,14,66,1204,3746,11366,2791,7404,559,5461,1384,42600,190
IN SD,Pike,Indiana,18125,-87.27713394,38.39229584,12509,36.68,4925,6156,6353,12469,3,16,19,2,40,791,2273,7478,1967,5487,562,4070,855,35700,174
IN SD,Posey,Indiana,18129,-87.89945221,38.00549698,25968,63.49,9508,12834,13134,25588,283,38,34,25,104,1977,5307,15579,3105,10401,893,7633,1875,58800,213
IN SD,Putnam,Indiana,18133,-86.83441544,39.66769028,30315,62.89,9996,15541,14774,29196,826,77,154,62,182,1827,5179,19465,3844,10981,985,7584,2412,51600,242
IN SD,Randolph,Indiana,18135,-85.0056572,40.16508484,27148,59.8,10451,13132,14016,26947,56,49,37,59,192,1775,5251,15946,4176,11327,876,7900,2551,35500,185
IN SD,Ripley,Indiana,18137,-85.26554489,39.11124802,24616,55.07,8778,12056,12560,24501,16,44,38,17,62,1811,5208,14115,3482,9587,809,6660,2118,49000,215
IN SD,Rush,Indiana,18139,-85.47548294,39.61518288,18129,44.43,6504,8778,9351,17901,142,15,60,11,61,1249,3811,10402,2667,7014,510,4678,1826,41200,199
IN SD,Scott,Indiana,18143,-85.73690033,38.69219398,20991,109.9,7593,10189,10802,20850,16,25,50,50,148,1501,4331,12666,2493,8078,485,5864,1729,38000,221
IN SD,Shelby,Indiana,18145,-85.80329895,39.51953125,40307,97.6,14761,19600,20707,39743,330,67,142,25,118,2956,8049,24373,4929,15654,893,10847,3914,51300,271
IN SD,Spencer,Indiana,18147,-87.02375031,37.993536,19490,48.73,6962,9738,9752,19295,111,37,33,14,89,1353,3967,11626,2544,7636,674,5661,1301,47000,191
IN SD,Sullivan,Indiana,18153,-87.461586,39.08021736,18993,42.02,7364,9098,9895,18905,15,39,15,19,59,1155,3681,10762,3395,8487,1123,5892,1472,32300,164
IN SD,Switzerland,Indiana,18155,-85.00038528,38.81347084,7738,34.7,2839,3800,3938,7695,15,16,10,2,22,513,1579,4477,1169,3732,893,2245,594,37700,174
IN SD,Tipton,Indiana,18159,-86.05424881,40.31947708,16119,62,6026,7838,8281,15990,10,20,51,48,121,1016,3199,9520,2384,6427,401,4632,1394,50900,238
IN SD,Union,Indiana,18161,-84.92671967,39.62276649,6976,43.06,2576,3384,3592,6915,20,15,21,5,25,465,1485,4059,967,2813,237,1863,713,41800,188
IN SD,Vanderburgh,Indiana,18163,-87.58083344,38.00096512,165058,699.4,66780,77714,87344,151216,12410,284,917,231,883,11443,27967,99700,25948,72637,5857,43287,23493,52100,265
IN SD,Vermillion,Indiana,18165,-87.45388794,39.88707161,16773,64.51,6638,7956,8817,16690,15,32,28,8,61,1007,3163,9706,2897,7288,650,5322,1316,32300,186
IN SD,Vigo,Indiana,18167,-87.42007828,39.43309593,106107,261.99,39804,51991,54116,98411,5916,297,1161,322,997,6609,17770,65737,15991,44203,4399,27568,12236,40000,236
IN SD,Warren,Indiana,18171,-87.31794357,40.31244659,8176,22.34,3015,4032,4144,8140,1,17,15,3,23,575,1566,4816,1219,3275,260,2371,644,39700,176
IN SD,Warrick,Indiana,18173,-87.25109863,38.05851936,44920,114.88,15817,22104,22816,44274,371,83,157,35,168,3152,9571,27567,4630,16926,1109,12917,2900,64800,266
IN SD,Washington,Indiana,18175,-86.08581543,38.5990963,23717,45.96,8664,11794,11923,23625,23,28,18,23,108,1609,4884,14020,3204,9520,856,6933,1731,40000,200
IN SD,Wayne,Indiana,18177,-85.01459885,39.8650856,71951,178.1,27587,34352,37599,67532,3795,153,296,175,374,4769,13374,42920,10888,29586,1999,18650,8937,42400,231
KS D,Allen,Kansas,20001,-95.29707336,37.88155746,14638,28.99,5705,7039,7599,14128,270,100,46,94,258,1006,2978,7877,2777,6454,749,4282,1423,27600,174
KS D,Anderson,Kansas,20003,-95.28660583,38.20914268,7803,13.36,3067,3758,4045,7672,40,67,10,14,51,518,1544,4023,1718,3514,447,2388,679,27200,159
KS D,Atchison,Kansas,20005,-95.2616539,39.5296154,16932,39.29,6129,8256,8676,15598,957,84,131,162,370,1183,3494,9396,2859,6691,562,4482,1647,32400,184
KS D,Barber,Kansas,20007,-98.67575455,37.23195839,5874,5.17,2358,2819,3055,5791,13,31,3,36,73,393,1176,3048,1257,3120,762,1772,586,28400,193
KS D,Barton,Kansas,20009,-98.75030899,38.47109032,29382,32.83,11561,14176,15206,28392,348,141,109,392,816,2231,5694,16544,4913,13144,1583,8357,3204,37700,211
KS D,Bourbon,Kansas,20011,-94.84969711,37.85308075,14966,23.46,5897,7041,7925,14438,419,60,22,27,79,1071,2806,8038,3051,6920,1023,4352,1545,29800,179
KS D,Brown,Kansas,20013,-95.55645752,39.81983566,11128,19.45,4347,5333,5795,10190,132,719,16,71,192,817,2242,5652,2417,4890,543,3070,1277,28000,159
KS D,Butler,Kansas,20015,-96.83141327,37.77893066,50580,35.05,18488,24845,25735,49311,367,459,169,274,742,3822,10785,29203,6770,20072,1584,13931,4557,51800,243
KS D,Chase,Kansas,20017,-96.59384918,38.30055618,3021,3.89,1214,1497,1524,2995,5,11,1,9,40,197,557,1567,700,1547,333,918,296,22400,151
KS D,Chautauqua,Kansas,20019,-96.23830032,37.14795113,4407,6.84,1835,2143,2264,4202,23,152,13,17,44,268,765,2207,1167,2249,414,1466,369,18900,141
KS D,Cherokee,Kansas,20021,-94.84521866,37.16627121,21374,36.23,8396,10189,11185,20442,116,760,24,32,175,1427,4214,11962,3771,9428,1032,6421,1975,27000,166
KS D,Cheyenne,Kansas,20023,-101.7286949,39.78190804,3243,3.18,1389,1553,1690,3224,5,1,9,4,20,200,582,1679,782,1687,298,1050,339,31900,144
KS D,Clark,Kansas,20025,-99.82499313,37.23208237,2418,2.48,1006,1172,1246,2355,0,27,7,29,42,133,473,1229,583,1327,321,758,248,29500,189
KS D,Clay,Kansas,20027,-97.15537643,39.34503365,9158,14.49,3641,4437,4721,9078,18,17,27,18,38,593,1747,4718,2100,4138,497,2674,967,33800,169
KS D,Cloud,Kansas,20029,-97.64452362,39.47627258,11023,15.35,4483,5179,5844,10917,37,17,5,47,76,661,1862,5773,2727,5198,715,3247,1236,25600,152
KS D,Coffey,Kansas,20031,-95.72737122,38.23299599,8404,13.67,3311,4159,4245,8315,9,54,18,8,61,563,1725,4468,1648,3712,401,2559,752,34800,194
KS D,Comanche,Kansas,20033,-99.27133179,37.18747139,2313,2.93,950,1107,1206,2291,6,12,0,4,13,152,412,1144,605,1256,306,682,268,24300,153
KS D,Cowley,Kansas,20035,-96.82756042,37.23640251,36915,32.73,14047,17890,19025,34290,1060,714,330,521,1097,2594,7192,21109,6020,15569,1522,10002,4045,37500,213
KS D,Crawford,Kansas,20037,-94.8511734,37.50375175,35568,59.78,14606,17080,18488,34250,476,305,422,115,325,2158,6126,20312,6972,16526,1920,9861,4745,30700,207
KS D,Decatur,Kansas,20039,-100.4582024,39.78062057,4021,4.5,1651,1953,2068,4001,2,9,1,8,13,280,758,1999,984,2063,412,1240,411,28800,166
KS D,Dickinson,Kansas,20041,-97.12689972,38.86121178,18958,22.25,7542,9128,9830,18589,123,65,54,127,341,1286,3659,10247,3766,8415,873,5544,1998,35600,190
KS D,Doniphan,Kansas,20043,-95.10029984,39.81066513,8134,20.96,3074,3992,4142,7839,155,97,18,25,48,536,1583,4545,1470,3337,263,2318,756,29200,164
KS D,Douglas,Kansas,20045,-95.27402878,38.89833069,81798,177.44,30138,40722,41076,72885,3324,2161,2581,847,2138,5132,11596,58443,6627,31782,1644,15823,14315,68000,343
KS D,Edwards,Kansas,20047,-99.28640747,37.90395927,3787,6.11,1585,1828,1959,3646,4,12,8,117,197,222,725,1954,886,1867,282,1193,392,24900,160
KS D,Elk,Kansas,20049,-96.23626709,37.44836235,3327,5.12,1436,1591,1736,3238,5,57,3,24,59,197,520,1622,988,1743,307,1149,287,14999,111
KS D,Ellis,Kansas,20051,-99.31108856,38.90921593,26004,28.89,10096,12739,13265,25635,109,45,151,64,205,1774,4957,15804,3469,11115,1019,6501,3595,49600,227
KS D,Ellsworth,Kansas,20053,-98.20254517,38.6886425,6586,9.19,2522,3409,3177,6347,134,26,10,69,186,372,1187,3561,1466,3317,795,1952,570,28300,166
KS D,Finney,Kansas,20055,-100.660511,37.99355316,33070,25.4,10836,16787,16283,26460,443,253,1203,4711,8353,3493,7809,19209,2559,11696,860,6665,4171,50800,300
KS D,Ford,Kansas,20057,-99.88841248,37.68663406,27463,24.99,9872,13859,13604,22873,473,155,663,3299,4083,2459,5496,16040,3468,10842,970,6407,3465,48900,263
KS D,Franklin,Kansas,20059,-95.28184509,38.56075668,21994,38.12,8308,10652,11342,21202,282,187,100,223,471,1759,4400,12403,3432,8926,618,6037,2271,37700,216
KS D,Geary,Kansas,20061,-96.72426224,39.03852272,30453,80.78,10676,15621,14832,20938,7198,203,1224,890,1853,3387,5609,19117,2340,11952,1276,4853,5823,55400,283
KS D,Gove,Kansas,20063,-100.4816322,38.91139984,3231,3.01,1284,1604,1627,3219,4,5,2,1,9,220,649,1714,648,1494,210,1023,261,30300,148
KS D,Graham,Kansas,20065,-99.88246155,39.34208488,3543,3.95,1435,1739,1804,3407,103,13,12,8,23,211,716,1894,722,1753,318,1102,333,24900,145
KS D,Grant,Kansas,20067,-101.3005066,37.56026077,7159,12.45,2393,3576,3583,6059,2,78,41,979,1543,643,1825,4066,625,2599,206,1656,737,53200,263
KS D,Gray,Kansas,20069,-100.4298859,37.7326889,5396,6.22,1913,2649,2747,5168,7,22,1,198,229,464,1264,2948,720,2114,201,1385,528,45500,204
KS D,Greeley,Kansas,20071,-101.8037453,38.47354317,1774,2.28,656,881,893,1687,11,2,2,72,107,153,394,949,278,801,145,460,196,39500,206
KS D,Greenwood,Kansas,20073,-96.23602676,37.88371277,7847,6.91,3285,3808,4039,7719,9,77,0,42,91,467,1399,3997,1984,4243,958,2438,847,21900,156
KS D,Hamilton,Kansas,20075,-101.7829857,37.99416542,2388,2.39,986,1134,1254,2244,5,8,28,103,139,163,453,1299,473,1214,228,698,288,37800,197
KS D,Harper,Kansas,20077,-98.07463837,37.19112015,7124,8.88,3007,3432,3692,7036,13,46,5,24,105,472,1334,3667,1651,3481,474,2203,804,32300,183
KS D,Harvey,Kansas,20079,-97.42351151,38.03971481,31028,57.46,11581,15035,15993,29300,551,145,212,820,1616,2130,6040,17759,5099,12290,709,7925,3656,47100,231
KS D,Haskell,Kansas,20081,-100.864605,37.56056976,3886,6.72,1372,1961,1925,3413,2,23,5,443,557,348,917,2220,401,1586,214,960,412,45900,229
KS D,Hodgeman,Kansas,20083,-99.89470673,38.0782814,2177,2.53,826,1079,1098,2137,22,3,1,14,32,176,435,1151,415,1022,196,669,157,26800,158
KS D,Jackson,Kansas,20085,-95.78976822,39.42988396,11525,17.52,4277,5654,5871,10705,41,722,9,48,126,842,2460,6357,1866,4564,287,3480,797,34300,183
KS D,Jefferson,Kansas,20087,-95.38421631,39.22377968,15905,29.73,5778,7995,7910,15603,73,129,65,35,132,1085,3277,9202,2341,6314,536,4845,933,47100,223
KS D,Jewell,Kansas,20089,-98.21592331,39.77871704,4251,4.67,1806,2105,2146,4233,0,12,5,1,8,275,741,2181,1054,2409,603,1421,385,14999,116
KS D,Johnson,Kansas,20091,-94.8315506,38.8893528,355054,742.79,136433,171609,183445,338770,6917,1246,5840,2281,7005,28049,67067,226518,33420,144155,7722,94661,41772,91500,438
KS D,Kearny,Kansas,20093,-101.3121834,37.99397469,4027,4.64,1379,2046,1981,3602,4,26,5,390,671,373,969,2226,459,1561,182,957,422,45900,254
KS D,Kingman,Kansas,20095,-98.12818527,37.55200577,8292,9.59,3175,4030,4262,8213,9,24,10,36,77,591,1705,4352,1644,3645,470,2399,776,34600,199
KS D,Kiowa,Kansas,20097,-99.27885437,37.55461311,3660,5.06,1466,1753,1907,3600,7,17,11,25,39,238,711,1938,773,1738,272,1050,416,33600,173
KS D,Labette,Kansas,20099,-95.29863739,37.19086647,23693,36.28,9377,11366,12327,21956,1030,409,97,201,516,1698,4594,13030,4371,10641,1264,6869,2508,29000,187
KS D,Lane,Kansas,20101,-100.4611397,38.47297287,2375,3.31,966,1199,1176,2354,1,5,0,15,44,160,495,1227,493,1117,151,724,242,32600,169
KS D,Leavenworth,Kansas,20103,-94.98563385,39.18596458,64371,139.03,19715,35453,28918,55063,7132,418,937,821,2192,4511,12653,41074,6133,21264,1549,12849,6866,64000,342
KS D,Lincoln,Kansas,20105,-98.20706177,39.03586578,3653,5.07,1531,1741,1912,3635,1,11,1,5,15,206,667,1830,950,1864,333,1206,325,17200,112
KS D,Linn,Kansas,20107,-94.84405136,38.21118355,8254,13.73,3215,4049,4205,8151,37,44,6,16,34,519,1588,4339,1808,4811,1596,2577,638,26800,151
KS D,Logan,Kansas,20109,-101.1430206,38.91195869,3081,2.87,1221,1519,1562,3047,11,8,0,15,26,210,606,1645,620,1466,245,936,285,30800,157
KS D,Lyon,Kansas,20111,-96.14717102,38.44932365,34732,41.15,13059,16957,17775,31828,731,215,686,1272,2114,2667,6623,21184,4258,14346,1287,8011,5048,45800,234
KS D,Marion,Kansas,20115,-97.08952713,38.33948326,12888,13.65,4975,6172,6716,12687,82,38,32,49,118,744,2269,6858,3017,5659,684,3937,1038,30700,176
KS D,Marshall,Kansas,20117,-96.51776123,39.77711868,11705,13.33,4689,5718,5987,11632,10,34,11,18,49,829,2269,5923,2684,5269,580,3657,1032,26300,156
KS D,McPherson,Kansas,20113,-97.64399719,38.38463402,27268,30.3,10230,13262,14006,26663,211,108,125,161,325,1903,5202,15418,4745,10941,711,7483,2747,47900,224
KS D,Meade,Kansas,20119,-100.3671989,37.23478127,4247,4.34,1667,2085,2162,4092,0,11,12,132,198,295,862,2282,808,2049,382,1208,459,35900,192
KS D,Miami,Kansas,20121,-94.83694839,38.5624218,23466,39.77,8402,11538,11928,22635,565,137,38,91,276,1683,4835,13703,3245,8971,569,6476,1926,47700,235
KS D,Mitchell,Kansas,20123,-98.20484161,39.38546371,7203,10.05,2846,3479,3724,7123,44,18,10,8,29,457,1467,3702,1577,3359,513,2105,741,28800,174
KS D,Montgomery,Kansas,20125,-95.73794174,37.19046211,38816,60.09,15670,18322,20494,35000,2437,898,154,327,751,2783,7240,21285,7508,17920,2250,11328,4342,29400,192
KS D,Morris,Kansas,20127,-96.63767624,38.68916321,6198,8.94,2528,3023,3175,6101,20,31,11,35,90,403,1155,3269,1371,3149,621,1916,612,33500,176
KS D,Morton,Kansas,20129,-101.7971344,37.18906021,3480,4.76,1290,1712,1768,3297,3,31,38,111,352,272,786,1950,472,1515,225,938,352,44700,218
KS D,Nemaha,Kansas,20131,-96.01037216,39.77669144,10446,14.53,3996,5159,5287,10378,37,13,16,2,14,828,2173,5301,2144,4319,323,3220,776,35400,163
KS D,Neosho,Kansas,20133,-95.30435181,37.55522537,17035,29.57,6748,8170,8865,16544,190,134,40,127,361,1192,3206,9405,3232,7726,978,5050,1698,28600,180
KS D,Ness,Kansas,20135,-99.91125107,38.47236252,4033,3.76,1670,1985,2048,4016,0,4,5,8,23,237,823,2073,900,2048,378,1336,334,29900,163
KS D,Norton,Kansas,20137,-99.90257645,39.78105927,5947,6.81,2330,3090,2857,5724,135,16,20,52,82,339,984,3290,1334,2798,468,1745,585,25700,163
KS D,Osage,Kansas,20139,-95.72352219,38.64639854,15248,21.94,5806,7422,7826,15035,34,107,18,54,187,1033,3087,8453,2675,6324,518,4596,1210,38300,189
KS D,Osborne,Kansas,20141,-98.76391602,39.3438282,4867,5.52,2057,2329,2538,4835,4,20,6,2,17,330,847,2374,1316,2496,439,1616,441,18400,138
KS D,Ottawa,Kansas,20143,-97.64302444,39.13143539,5634,7.81,2266,2728,2906,5599,4,16,8,7,34,365,1072,3031,1166,2591,325,1783,483,27500,162
KS D,Pawnee,Kansas,20145,-99.24449921,38.16940308,7555,10.01,2923,3819,3736,7079,239,27,57,153,256,452,1505,4152,1446,3412,489,2085,838,35300,197
KS D,Phillips,Kansas,20147,-99.34464264,39.78037262,6590,7.43,2695,3200,3390,6524,16,12,28,10,32,427,1225,3415,1523,3264,569,2059,636,26800,155
KS D,Pottawatomie,Kansas,20149,-96.3715477,39.34106255,16128,19.48,5938,8029,8099,15799,93,115,61,60,239,1316,3428,9029,2355,6472,534,4594,1344,46400,219
KS D,Pratt,Kansas,20151,-98.73251343,37.64053726,9702,13.2,3937,4697,5005,9358,116,64,30,134,183,620,1878,5349,1855,4620,683,2908,1029,37500,222
KS D,Rawlins,Kansas,20153,-101.0707855,39.78357124,3404,3.18,1361,1680,1724,3382,3,7,8,4,27,209,692,1778,725,1744,383,1038,323,27500,168
KS D,Reno,Kansas,20155,-98.08300781,37.9468441,62389,49.55,24239,30658,31731,58612,1712,359,210,1496,2478,4298,11593,36379,10119,26607,2368,16954,7285,40100,233
KS D,Republic,Kansas,20157,-97.64494705,39.82393456,6482,9.02,2769,3099,3383,6452,3,12,12,3,15,394,1080,3208,1800,3283,514,2171,598,18900,135
KS D,Rice,Kansas,20159,-98.20059586,38.33477402,10610,14.57,4165,5068,5542,10222,117,53,19,199,279,760,2029,5683,2138,4868,703,3130,1035,27200,165
KS D,Riley,Kansas,20161,-96.6690712,39.29987717,67139,113.22,21280,36952,30187,55866,6807,482,2400,1584,2799,5009,9448,48427,4255,22868,1588,9393,11887,63500,323
KS D,Rooks,Kansas,20163,-99.32176208,39.34499741,6039,6.8,2444,2914,3125,5974,35,12,5,13,25,443,1169,3114,1313,2979,535,1896,548,25800,153
KS D,Rush,Kansas,20165,-99.30375671,38.51555634,3842,5.35,1642,1854,1988,3814,0,5,5,18,35,224,652,1998,968,1999,357,1330,312,19200,143
KS D,Russell,Kansas,20167,-98.75748825,38.90778351,7835,9.02,3371,3780,4055,7734,43,35,6,17,45,433,1378,4163,1861,4079,708,2556,815,28000,169
KS D,Saline,Kansas,20169,-97.64494324,38.7783947,49301,68.38,19826,23819,25482,46272,1515,239,531,744,1222,3643,9331,29363,6964,21129,1303,13216,6610,45500,249
KS D,Scott,Kansas,20171,-100.8958168,38.47582626,5289,7.37,2022,2625,2664,5144,5,9,22,109,138,406,1125,2901,857,2305,283,1495,527,44000,225
KS D,Sedgwick,Kansas,20173,-97.47164917,37.6884346,403662,400.86,156571,197617,206045,345173,36061,4556,8728,9144,17435,34422,77537,245717,45986,170159,13588,99753,56818,58500,302
KS D,Seward,Kansas,20175,-100.8524857,37.19257164,18743,29.29,6614,9472,9271,14495,1108,143,449,2548,3660,1732,4146,11107,1758,7572,958,4271,2343,48800,285
KS D,Shawnee,Kansas,20177,-95.7642746,39.03830338,160976,293.22,63768,77626,83350,141189,13365,1836,1179,3407,7785,11670,30023,98198,21085,68991,5223,42450,21318,55700,307
KS D,Sheridan,Kansas,20179,-100.4392738,39.34500885,3043,3.4,1171,1549,1494,3019,0,8,6,10,26,223,650,1627,543,1324,153,932,239,27600,147
KS D,Sherman,Kansas,20181,-101.7165909,39.34695053,6926,6.55,2733,3386,3540,6569,17,8,16,316,474,542,1297,3931,1156,3177,444,1905,828,37900,197
KS D,Smith,Kansas,20183,-98.78426361,39.77934456,5078,5.66,2165,2439,2639,5063,4,7,3,1,7,270,868,2519,1421,2615,450,1724,441,20700,125
KS D,Stafford,Kansas,20185,-98.74238968,38.03466225,5365,6.81,2203,2583,2782,5271,10,26,9,49,112,376,1001,2740,1248,2666,463,1667,536,24000,160
KS D,Stanton,Kansas,20187,-101.7818451,37.56032372,2333,3.43,831,1159,1174,2015,2,17,8,291,392,214,537,1328,254,956,125,537,294,44500,207
KS D,Stevens,Kansas,20189,-101.3099899,37.19342613,5048,6.94,1885,2473,2575,4552,26,42,15,413,552,434,1111,2782,721,2116,231,1397,488,48800,233
KS D,Sumner,Kansas,20191,-97.4706459,37.23473358,25841,21.84,9689,12573,13268,24869,140,288,72,472,888,1954,5540,14031,4316,10769,1080,7420,2269,39300,201
KS D,Thomas,Kansas,20193,-101.0510178,39.34748459,8258,7.68,3124,4025,4233,8109,29,17,35,68,101,620,1716,4711,1211,3534,410,2130,994,45400,205
KS D,Trego,Kansas,20195,-99.86936569,38.91021729,3694,4.15,1464,1822,1872,3668,2,6,17,1,9,211,755,1853,875,1851,387,1153,311,27900,153
KS D,Wabaunsee,Kansas,20197,-96.21662521,38.96857834,6603,8.28,2482,3264,3339,6493,41,24,7,38,116,450,1336,3650,1167,2853,371,2005,477,34600,168
KS D,Wallace,Kansas,20199,-101.7606163,38.9102459,1821,1.99,677,926,895,1785,6,5,4,21,79,145,384,993,299,840,163,501,176,28400,157
KS D,Washington,Kansas,20201,-97.08135605,39.77968979,7073,7.88,2862,3467,3606,7050,4,7,0,12,22,420,1317,3477,1859,3355,493,2241,621,18500,124
KS D,Wichita,Kansas,20203,-101.3396034,38.47545242,2758,3.84,996,1371,1387,2455,1,9,8,285,326,238,636,1470,414,1190,194,703,293,37900,183
KS D,Wilson,Kansas,20205,-95.74122238,37.55591393,10289,17.89,4194,4929,5360,10150,20,70,16,33,76,679,1960,5385,2265,5091,897,3257,937,23500,160
KS D,Woodson,Kansas,20207,-95.73405457,37.8823185,4116,8.27,1699,1997,2119,4059,15,30,5,7,25,246,742,2040,1088,2199,500,1325,374,18800,142
KS D,Wyandotte,Kansas,20209,-94.75286484,39.09486389,161993,1087.2,61514,77251,84742,108728,44469,1110,1876,5810,10997,13462,32603,94894,21034,69102,7588,38714,22800,42300,285
KY ED,Anderson,Kentucky,21005,-85.00075912,37.99814987,14571,71.43,5438,7113,7458,14089,432,4,20,26,68,1028,2823,8908,1812,5804,366,4464,974,51500,244
KY ED,Barren,Kentucky,21009,-85.96102142,36.94737053,34001,70.54,13136,16109,17892,32208,1680,33,58,22,94,2170,6292,20120,5419,14202,1066,9294,3842,43300,188
KY ED,Bath,Kentucky,21011,-83.72550201,38.15211296,9692,34.99,3659,4720,4972,9393,277,8,7,7,31,632,1807,5777,1476,4021,362,2800,859,31000,125
KY ED,Bell,Kentucky,21013,-83.71149826,36.7710247,31506,87.27,11512,15178,16328,30570,804,39,83,10,77,2092,6445,18783,4186,12568,1056,7570,3942,34200,163
KY ED,Boone,Kentucky,21015,-84.74752045,38.96133614,57589,234.1,20127,28111,29478,56716,361,88,355,69,318,4675,12238,35926,4750,21476,1349,14488,5639,74500,356
KY ED,Bourbon,Kentucky,21017,-84.21268845,38.21734619,19236,65.88,7250,9321,9915,17504,1662,20,25,25,81,1329,3722,11556,2629,7781,531,4538,2712,51300,241
KY ED,Boyd,Kentucky,21019,-82.69551849,38.37296104,51150,319.69,19876,24789,26361,49851,1040,66,148,45,443,2962,9021,31595,7572,21365,1489,14452,5424,45400,221
KY ED,Boyle,Kentucky,21021,-84.86098099,37.62570572,25641,140.88,9483,12580,13061,23084,2444,15,80,18,108,1517,4678,15731,3715,10191,708,6495,2988,54700,245
KY ED,Bracken,Kentucky,21023,-84.0766716,38.67875671,7766,38.26,2872,3759,4007,7710,47,8,1,0,12,513,1506,4552,1195,3166,294,2166,706,39400,135
KY ED,Breathitt,Kentucky,21025,-83.2741394,37.5169487,15703,31.72,5555,7773,7930,15637,33,12,20,1,26,1050,3450,9490,1713,6127,572,3986,1569,28700,143
KY ED,Campbell,Kentucky,21037,-84.37535858,38.95908928,83866,551.75,31169,40126,43740,82582,851,104,258,71,319,6497,16002,50584,10783,32910,1741,21268,9901,62300,298
KY ED,Carroll,Kentucky,21041,-85.13823318,38.67863464,9292,71.48,3505,4503,4789,9057,199,17,15,4,22,628,1893,5475,1296,3870,365,2301,1204,41700,194
KY ED,Carter,Kentucky,21043,-83.06116104,38.34505463,24340,59.8,8679,11916,12424,24270,20,24,17,9,60,1512,4992,14728,3108,9290,611,6946,1733,37100,183
KY ED,Clark,Kentucky,21049,-84.16609955,37.96974373,29496,115.67,10973,14181,15315,27740,1615,74,44,23,98,1988,5641,18179,3688,11635,662,7492,3481,56900,264
KY ED,Clay,Kentucky,21051,-83.74384308,37.15024948,21746,46.17,7367,10714,11032,21329,335,34,32,16,46,1621,4965,12842,2318,7930,563,5277,2090,27800,139
KY ED,Elliott,Kentucky,21063,-83.08308411,38.13655663,6455,27.59,2324,3202,3253,6451,1,3,0,0,15,453,1426,3769,807,2639,315,1832,492,32300,116
KY ED,Estill,Kentucky,21065,-83.93305969,37.69428635,14614,57.09,5357,7017,7597,14593,8,7,3,3,46,898,3003,8703,2010,5863,506,3991,1366,30400,158
KY ED,Fayette,Kentucky,21067,-84.48361969,38.02737045,225366,790.76,89529,107761,117605,190448,30143,351,3713,711,2556,15314,35102,152638,22312,97742,8213,47460,42069,73900,338
KY ED,Fleming,Kentucky,21069,-83.71910477,38.35616493,12292,35.02,4626,6022,6270,12060,216,4,8,4,56,780,2341,7264,1907,5163,537,3523,1103,36500,140
KY ED,Floyd,Kentucky,21071,-82.7588768,37.52365685,43586,110.91,15664,21262,22324,43155,306,32,78,15,129,3093,9469,26000,5024,17169,1505,11693,3971,37800,198
KY ED,Franklin,Kentucky,21073,-84.89249802,38.23390388,43781,206.51,17385,21034,22747,40130,3304,67,225,55,178,2793,7773,27909,5306,18543,1158,11124,6261,60200,285
KY ED,Gallatin,Kentucky,21077,-84.85146332,38.76668549,5393,54.47,1941,2674,2719,5281,93,5,7,7,8,412,1124,3182,675,2290,349,1468,473,45300,168
KY ED,Garrard,Kentucky,21079,-84.55373764,37.64969826,11579,49.91,4435,5598,5981,11099,453,15,10,2,31,694,2093,7002,1790,4929,494,3303,1132,45800,180
KY ED,Grant,Kentucky,21081,-84.63668823,38.64047623,15737,60.76,5585,7739,7998,15670,27,13,19,8,36,1154,3390,9371,1822,6543,958,4303,1282,49600,217
KY ED,Greenup,Kentucky,21089,-82.91928101,38.56324196,36742,105.88,13414,17758,18984,36416,147,40,115,24,76,2099,7323,22855,4465,14657,1243,10951,2463,44100,228
KY ED,Harlan,Kentucky,21095,-83.18688965,36.84249496,36574,78.15,13269,17614,18960,35259,1212,34,54,15,109,2553,7964,21316,4741,14735,1466,9390,3879,29400,161
KY ED,Harrison,Kentucky,21097,-84.33282089,38.42867661,16248,52.41,6086,7858,8390,15709,479,24,14,22,42,1059,3281,9383,2525,6488,402,4120,1966,48500,198
KY ED,Henry,Kentucky,21103,-85.11760712,38.46571159,12823,44.07,4896,6298,6525,12255,538,15,10,5,29,878,2377,7749,1819,5447,551,3732,1164,41100,167
KY ED,Jackson,Kentucky,21109,-83.99747467,37.41713333,11955,34.55,4381,5903,6052,11935,2,13,2,3,31,834,2586,6957,1578,4895,514,3381,1000,26900,106
KY ED,Jessamine,Kentucky,21113,-84.58518982,37.86913109,30508,175.33,10601,14963,15545,29274,988,67,125,54,184,2247,6101,19499,2661,11209,608,7247,3354,63800,266
KY ED,Johnson,Kentucky,21115,-82.81738663,37.85596466,23248,88.06,8469,11364,11884,23113,33,20,75,7,38,1422,4914,14184,2728,9381,912,6254,2215,40100,195
KY ED,Kenton,Kentucky,21117,-84.51843262,38.94034195,142031,871.36,52690,68378,73653,136849,4158,180,635,209,704,11481,27740,86526,16284,56086,3396,34678,18012,65200,308
KY ED,Knott,Kentucky,21119,-82.92206955,37.35796165,17906,50.87,6086,8812,9094,17759,113,10,18,6,34,1179,4069,10780,1878,6718,632,4769,1317,27700,150
KY ED,Knox,Kentucky,21121,-83.8367157,36.87419891,29676,76.48,10718,14256,15420,29267,291,71,26,21,78,2111,6316,17388,3861,11731,1013,7369,3349,35300,174
KY ED,Laurel,Kentucky,21125,-84.1211586,37.13441277,43438,100.09,15585,21269,22169,42969,245,127,76,21,166,2909,9082,26491,4956,16923,1338,11902,3683,46900,201
KY ED,Lawrence,Kentucky,21127,-82.74897385,38.07766342,13998,33.33,5007,6899,7099,13926,22,23,23,4,24,906,3054,8221,1817,5684,677,3761,1246,40500,173
KY ED,Lee,Kentucky,21129,-83.72192001,37.60444069,7422,35.18,2760,3583,3839,7389,26,7,0,0,10,509,1550,4297,1066,3025,265,2072,688,28400,125
KY ED,Leslie,Kentucky,21131,-83.36013412,37.1053257,13642,33.94,4711,6747,6895,13611,12,9,8,2,40,1042,3094,8236,1270,5038,327,3656,1055,24400,120
KY ED,Letcher,Kentucky,21133,-82.86183929,37.12134361,27000,79.65,9731,13083,13917,26737,190,38,30,5,64,1682,6073,16085,3160,10808,1077,7644,2087,27300,149
KY ED,Lewis,Kentucky,21135,-83.33711243,38.52275467,13029,26.92,4713,6482,6547,12976,27,22,4,0,25,813,2797,7659,1760,5328,615,3715,998,31400,124
KY ED,Lincoln,Kentucky,21137,-84.66402817,37.44139671,20045,59.48,7431,9873,10172,19345,621,50,12,17,43,1372,3971,11859,2843,7985,554,5672,1759,37700,157
KY ED,Madison,Kentucky,21151,-84.30715179,37.71698761,57508,129.81,20012,27367,30141,54101,2920,82,321,84,191,3393,9463,38704,5948,21456,1444,12422,7590,55500,249
KY ED,Magoffin,Kentucky,21153,-83.08143997,37.69089317,13077,42.18,4440,6457,6620,13049,4,18,5,1,15,945,3107,7696,1329,4800,360,3462,978,35500,130
KY ED,Martin,Kentucky,21159,-82.49698257,37.81982231,12526,54.46,4300,6134,6392,12499,8,9,7,3,21,946,3027,7464,1089,4697,397,3385,915,37500,179
KY ED,Mason,Kentucky,21161,-83.8153801,38.61116791,16666,69.15,6537,8003,8663,15356,1267,11,23,9,76,1120,3158,9733,2655,7089,552,4241,2296,43800,171
KY ED,McCreary,Kentucky,21147,-84.51704025,36.77688026,15603,36.54,5479,7655,7948,15416,124,59,3,1,24,1170,3579,9114,1740,6039,560,4095,1384,26300,143
KY ED,Menifee,Kentucky,21165,-83.61352158,37.94113731,5092,25.08,1842,2553,2539,4987,87,5,4,9,27,335,1064,3074,619,2421,579,1507,335,32600,124
KY ED,Mercer,Kentucky,21167,-84.86857986,37.82432175,19148,76.59,7413,9155,9993,18217,817,21,83,10,87,1168,3526,11574,2880,8212,799,5393,2020,46600,222
KY ED,Montgomery,Kentucky,21173,-83.92115402,38.04911995,19561,98.3,7312,9425,10136,18686,816,21,19,19,56,1240,3919,11863,2539,7759,447,5131,2181,43600,210
KY ED,Morgan,Kentucky,21175,-83.23313904,37.91794205,11648,30.49,4089,5961,5687,11533,100,9,6,0,42,762,2449,6989,1448,4562,473,3129,960,36600,147
KY ED,Nicholas,Kentucky,21181,-84.02433014,38.32623672,6725,34.14,2621,3255,3470,6610,88,6,17,4,16,388,1324,3937,1076,2930,309,1884,737,38200,164
KY ED,Owen,Kentucky,21187,-84.83332062,38.52951431,9035,25.52,3412,4491,4544,8853,158,14,5,5,14,561,1849,5231,1394,4723,1311,2580,832,38200,159
KY ED,Owsley,Kentucky,21189,-83.70882416,37.39944458,5036,25.43,1848,2546,2490,5017,14,4,1,0,13,319,1017,2920,780,2137,289,1381,467,24400,113
KY ED,Pendleton,Kentucky,21191,-84.37167358,38.70256042,12036,42.83,4332,5890,6146,11955,43,23,7,8,29,968,2529,7085,1454,4782,450,3254,1078,43700,185
KY ED,Perry,Kentucky,21193,-83.28108597,37.22226334,30283,88.81,10598,14789,15494,29660,521,29,64,9,53,1950,6670,18468,3195,11565,967,7947,2651,34800,178
KY ED,Pike,Kentucky,21195,-82.34567642,37.46894264,72583,92.46,26148,35497,37086,72052,282,61,173,15,184,4561,15620,44668,7734,28760,2612,20101,6047,41300,219
KY ED,Powell,Kentucky,21197,-83.83956909,37.82813644,11686,64.92,4057,5734,5952,11574,82,10,8,12,41,854,2622,6985,1225,4458,401,3115,942,37400,180
KY ED,Pulaski,Kentucky,21199,-84.60738373,37.11552429,49489,74.98,18866,24029,25460,48671,599,103,91,25,205,3087,9130,30223,7049,22328,3462,14283,4583,44600,191
KY ED,Robertson,Kentucky,21201,-84.07603073,38.51191521,2124,21.24,820,1039,1085,2120,4,0,0,0,4,127,382,1242,373,955,135,596,224,33700,99
KY ED,Rockcastle,Kentucky,21203,-84.32720566,37.35094261,14803,46.55,5464,7305,7498,14760,3,17,14,9,52,995,2954,8892,1962,5958,494,4274,1190,31100,120
KY ED,Rowan,Kentucky,21205,-83.4210701,38.20831299,20353,72.17,6755,9762,10591,19879,309,40,95,30,74,1159,3039,14116,2039,7375,620,4505,2250,44400,205
KY ED,Scott,Kentucky,21209,-84.58776474,38.30230713,23867,83.45,8501,11548,12319,22201,1510,22,102,32,100,1622,4772,14878,2595,9173,672,5628,2873,68500,274
KY ED,Shelby,Kentucky,21211,-85.21959686,38.20426178,24824,64.48,9048,11874,12950,22218,2454,26,90,36,90,1601,4669,15305,3249,9617,569,6436,2612,58600,239
KY ED,Trimble,Kentucky,21223,-85.31391525,38.61579704,6090,41.15,2246,2984,3106,6063,2,20,2,3,29,435,1175,3636,844,2510,264,1830,416,43800,166
KY ED,Wayne,Kentucky,21231,-84.83164978,36.80158997,17468,39.17,6517,8601,8867,17098,318,39,7,6,53,1144,3573,10312,2439,7791,1274,4951,1566,30200,144
KY ED,Whitley,Kentucky,21235,-84.12428665,36.78010941,33326,75.23,12153,15934,17392,32997,213,60,52,4,90,2275,6775,19978,4298,13399,1246,8606,3547,36600,191
KY ED,Wolfe,Kentucky,21237,-83.48000336,37.74494171,6503,29.16,2451,3230,3273,6486,8,5,3,1,5,412,1465,3860,766,2779,328,1823,628,28200,100
KY ED,Woodford,Kentucky,21239,-84.75550842,38.01956749,19955,103.93,7223,9534,10421,18558,1294,27,28,48,98,1437,3833,12567,2118,7689,466,5139,2084,73800,305
KY WD,Adair,Kentucky,21001,-85.29478455,37.1205883,15360,37.74,5800,7507,7853,14853,459,15,24,9,89,886,2892,9173,2409,6434,634,4633,1167,35100,162
KY WD,Allen,Kentucky,21003,-86.18976593,36.78311157,14628,43.28,5595,7096,7532,14433,165,17,6,7,24,1029,2838,8405,2356,6381,786,4291,1304,35600,144
KY WD,Ballard,Kentucky,21007,-88.99822998,37.07300949,7902,31.11,3191,3860,4042,7638,240,14,6,4,41,442,1406,4622,1432,3553,362,2626,565,33000,136
KY WD,Breckinridge,Kentucky,21027,-86.42120361,37.80924797,16312,28.87,6159,8095,8217,15672,584,29,15,12,44,1047,3288,9511,2466,8261,2102,4955,1204,37700,164
KY WD,Bullitt,Kentucky,21029,-85.69528961,37.96722031,47567,158.56,15965,23711,23856,47152,206,84,93,32,164,3429,10494,30386,3258,16629,664,13465,2500,51000,249
KY WD,Butler,Kentucky,21031,-86.66917419,37.2039547,11245,26.09,4180,5569,5676,11156,55,18,14,2,38,732,2260,6583,1670,4698,518,3313,867,33700,151
KY WD,Caldwell,Kentucky,21033,-87.88990402,37.16502571,13232,38.13,5274,6249,6983,12416,771,34,9,2,30,805,2346,7583,2498,5794,520,3980,1294,33800,155
KY WD,Calloway,Kentucky,21035,-88.26551437,36.62884712,30735,79.62,11607,14782,15953,29558,961,30,134,52,160,1614,4377,19789,4955,13242,1635,8401,3206,51800,204
KY WD,Carlisle,Kentucky,21039,-88.99526978,36.87111855,5238,27.42,2106,2520,2718,5164,55,12,3,4,21,304,961,2995,978,2295,189,1776,330,30300,117
KY WD,Casey,Kentucky,21045,-84.9487114,37.33053207,14211,31.93,5436,6931,7280,14105,37,26,17,26,47,924,2854,8295,2138,6046,610,4351,1085,30900,127
KY WD,Christian,Kentucky,21047,-87.50231934,36.89995575,68941,95.49,21636,37162,31779,49465,16929,294,881,1372,2339,5926,12029,44149,6837,23429,1793,11564,10072,42400,253
KY WD,Clinton,Kentucky,21053,-85.14932251,36.75382996,9135,46.61,3591,4360,4775,9118,6,3,8,0,37,549,1720,5470,1396,4189,598,2724,867,27400,122
KY WD,Crittenden,Kentucky,21055,-88.08607864,37.33676338,9196,25.54,3646,4443,4753,9097,78,13,8,0,24,574,1716,5286,1620,4039,393,2887,759,30900,144
KY WD,Cumberland,Kentucky,21057,-85.41491318,36.77904129,6784,22.32,2714,3203,3581,6460,307,12,4,1,23,412,1200,3946,1226,3051,337,2035,679,27700,122
KY WD,Daviess,Kentucky,21059,-87.12002945,37.74729347,87189,188.31,33036,41656,45533,83168,3619,101,229,72,312,6373,17310,52305,11201,35041,2005,22744,10292,48000,230
KY WD,Edmonson,Kentucky,21061,-86.26609802,37.195364,10357,34.29,3843,5108,5249,10165,169,14,7,2,25,635,2088,6222,1412,5009,1166,3290,553,33000,142
KY WD,Fulton,Kentucky,21075,-89.19923401,36.5755558,8271,39.2,3378,3792,4479,6700,1537,12,16,6,25,509,1559,4517,1686,3684,306,2245,1133,33900,159
KY WD,Graves,Kentucky,21083,-88.65587234,36.7255497,33550,60.23,13377,16025,17525,31937,1519,36,44,14,93,2076,6063,19300,6111,14528,1151,10425,2952,38500,166
KY WD,Grayson,Kentucky,21085,-86.35448456,37.46904945,21050,42.7,7991,10275,10775,20900,71,35,34,10,89,1323,4171,12508,3048,10446,2455,6361,1630,35700,172
KY WD,Green,Kentucky,21087,-85.53344345,37.28888321,10371,35.89,4089,5044,5327,9988,349,11,11,12,60,580,1827,6107,1857,4523,434,3227,862,31700,135
KY WD,Hancock,Kentucky,21091,-86.80959702,37.8246727,7864,41.61,2795,3940,3924,7732,94,14,17,7,30,567,1727,4756,814,3080,285,2251,544,43600,188
KY WD,Hardin,Kentucky,21093,-85.98446655,37.72472,89240,141.88,29358,46896,42344,75918,9914,360,1843,1205,2506,7308,17956,57034,6942,32375,3017,18653,10705,58300,289
KY WD,Hart,Kentucky,21099,-85.91402817,37.29685974,14890,36.14,5740,7172,7718,13781,1067,22,8,12,65,971,2910,8739,2270,6501,761,4337,1403,31600,142
KY WD,Henderson,Kentucky,21101,-87.60878754,37.80800438,43044,98.27,16558,20617,22427,39754,3051,72,129,38,166,2955,8493,26123,5473,17932,1374,11074,5484,51000,254
KY WD,Hickman,Kentucky,21105,-89.00407791,36.65139198,5566,22.72,2188,2629,2937,5051,503,5,2,5,19,344,943,3118,1161,2374,186,1732,456,32000,120
KY WD,Hopkins,Kentucky,21107,-87.57961655,37.33777809,46126,83.56,17760,22128,23998,42847,3057,53,136,33,188,3102,8943,27281,6800,19325,1565,13358,4402,39600,195
KY WD,Jefferson,Kentucky,21111,-85.68609619,38.18992996,664937,1722.63,264138,313949,350988,544365,113435,1048,4766,1323,4365,45350,117226,412909,89452,282578,18440,170401,93737,57000,282
KY WD,Larue,Kentucky,21123,-85.68524933,37.57431221,11679,44.41,4503,5698,5981,11150,489,26,10,4,55,714,2211,6879,1875,4824,321,3589,914,39500,164
KY WD,Livingston,Kentucky,21139,-88.37557983,37.20320892,9062,29.04,3593,4439,4623,9023,14,17,7,1,30,515,1549,5599,1399,4177,584,3047,546,36500,172
KY WD,Logan,Kentucky,21141,-86.84544373,36.86296654,24416,43.91,9302,11749,12667,22234,2085,56,26,15,79,1582,4830,14323,3681,10303,1001,6824,2478,41200,189
KY WD,Lyon,Kentucky,21143,-88.07199478,37.02635574,6624,31.69,2355,3722,2902,6153,433,22,12,4,28,260,830,4363,1171,3460,1105,1879,476,46300,158
KY WD,Marion,Kentucky,21155,-85.28422165,37.57096672,16499,47.55,5688,8239,8260,14986,1471,18,21,3,42,1077,3441,9825,2156,6115,427,4375,1313,39500,165
KY WD,Marshall,Kentucky,21157,-88.3057518,36.91222,27205,89.49,10789,13265,13940,27085,10,50,30,30,118,1599,4708,16196,4702,12528,1739,8936,1853,47600,185
KY WD,McCracken,Kentucky,21145,-88.71101761,37.08185387,62879,250.51,25625,29532,33347,56194,6320,96,189,80,324,3921,11399,37355,10204,27581,1956,17470,8155,48500,213
KY WD,McLean,Kentucky,21149,-87.27811432,37.53526878,9628,37.61,3672,4735,4893,9571,46,8,3,0,15,588,1816,5706,1518,4042,370,2941,731,36200,140
KY WD,Meade,Kentucky,21163,-86.24422455,37.99899292,24170,78.99,8080,12012,12158,21154,2382,85,258,291,578,2437,5549,14515,1669,8907,827,4957,3123,49700,329
KY WD,Metcalfe,Kentucky,21169,-85.61611938,37.00596428,8963,30.8,3433,4294,4669,8708,223,16,10,6,27,560,1654,5341,1408,3793,360,2658,775,31300,126
KY WD,Monroe,Kentucky,21171,-85.70949554,36.73218536,11401,34.44,4505,5448,5953,11025,350,8,10,8,64,697,2127,6746,1831,4882,377,3375,1130,31500,125
KY WD,Muhlenberg,Kentucky,21177,-87.14324951,37.23407555,31318,65.52,11683,15104,16214,29928,1287,40,33,30,82,1912,6146,18522,4738,12754,1071,9445,2238,37300,180
KY WD,Nelson,Kentucky,21179,-85.45417023,37.75981331,29710,70.07,10417,14443,15267,27781,1811,22,69,27,131,2198,6443,17728,3341,11078,661,8121,2296,45800,222
KY WD,Ohio,Kentucky,21183,-86.86159515,37.47657204,21105,35.41,7816,10152,10953,20849,179,40,31,6,80,1416,4310,12127,3252,8680,864,6183,1633,34300,174
KY WD,Oldham,Kentucky,21185,-85.46981812,38.41547394,33263,175.07,10673,17320,15943,31818,1197,76,124,48,206,2177,7352,21488,2246,11202,529,8871,1802,86500,277
KY WD,Russell,Kentucky,21207,-85.06568527,37.0110836,14716,58.86,5896,7077,7639,14605,92,12,4,3,40,873,2603,8867,2373,7375,1479,4752,1144,38900,162
KY WD,Simpson,Kentucky,21213,-86.59062958,36.77103424,15145,64.17,5767,7317,7828,13414,1667,24,25,15,48,1090,2944,8925,2186,6172,405,4061,1706,46300,230
KY WD,Spencer,Kentucky,21215,-85.31443024,38.04886246,6801,35.42,2451,3403,3398,6671,113,3,11,3,6,450,1381,4145,825,2640,189,1824,627,49300,177
KY WD,Taylor,Kentucky,21217,-85.34456253,37.33345985,21146,78.32,8216,10215,10931,20017,1081,17,30,1,45,1343,3905,12916,2982,8798,582,5942,2274,41500,197
KY WD,Todd,Kentucky,21219,-87.20365524,36.86434174,10940,29.02,4104,5289,5651,9693,1198,17,11,21,55,752,2125,6317,1746,4415,311,3109,995,34100,148
KY WD,Trigg,Kentucky,21221,-87.91772842,36.82374763,10361,24.61,4104,5043,5318,9098,1227,15,14,7,28,596,1761,5995,2009,5284,1180,3258,846,44300,176
KY WD,Union,Kentucky,21225,-87.94879532,37.68662643,16557,48.55,5580,8495,8062,13902,2545,34,47,29,122,991,3722,9808,2036,6091,511,4266,1314,38700,186
KY WD,Warren,Kentucky,21227,-86.40073013,36.98659706,76673,139.91,28819,36726,39947,69566,6250,115,644,98,429,4899,13742,49508,8524,31065,2246,18727,10092,57600,265
KY WD,Washington,Kentucky,21229,-85.20373154,37.77004051,10441,34.69,3709,4998,5443,9483,913,8,20,17,56,720,2097,5999,1625,4009,300,2927,782,40700,158
KY WD,Webster,Kentucky,21233,-87.6635704,37.50241089,13955,41.53,5372,6707,7248,13099,786,26,26,18,28,863,2803,7969,2320,5914,542,4188,1184,29000,156
LA ED,Assumption,Louisiana,22007,-91.06890106,29.86338329,22753,66.53,7397,11032,11721,15273,7349,44,72,15,292,1860,5354,13075,2464,8644,1247,6101,1296,45200,168
LA ED,Jefferson,Louisiana,22051,-90.12375641,29.61903191,448306,1288.24,166398,215430,232876,351170,79042,1753,9986,6355,26611,32777,87662,282095,45772,185072,18674,104611,61787,71500,334
LA ED,LaFourche,Louisiana,22057,-90.51275635,29.5137682,85860,75.25,28835,41971,43889,72371,10703,1909,678,199,1249,7091,18723,52049,7997,31332,2497,21833,7002,52300,202
LA ED,Orleans,Louisiana,22071,-89.89175797,30.02287197,496938,2497.18,188235,230883,266055,173554,307728,759,9678,5219,17238,38574,97888,295818,64658,225573,37338,82279,105956,69600,277
LA ED,Plaquemines,Louisiana,22075,-89.5442009,29.42577457,25575,24.71,8213,12951,12624,18522,5944,475,518,116,590,2152,5864,15527,2032,9432,1219,6236,1977,62200,298
LA ED,St. Bernard,Louisiana,22087,-89.68810272,29.84008312,66631,137.1,23156,32004,34627,62199,3111,356,626,339,4183,4917,13222,40913,7579,25147,1991,17556,5600,63300,294
LA ED,St. Charles,Louisiana,22089,-90.34514999,29.89830971,42437,148.38,14333,20742,21695,31638,10253,113,177,256,1070,3896,9483,25924,3134,16016,1683,11302,3031,68000,294
LA ED,St. James,Louisiana,22093,-90.79947662,30.03061104,20879,84.19,6432,9991,10888,10484,10357,5,19,14,107,1812,4823,12209,2035,6934,502,5300,1132,57100,114
LA ED,St. John the Baptist,Louisiana,22095,-90.4990921,30.10136795,39996,187.77,12710,19577,20419,25039,14419,100,158,280,954,3838,9810,23519,2829,14255,1545,10128,2582,62200,276
LA ED,St. Tammany,Louisiana,22103,-89.91411972,30.44642067,144508,165.53,50346,71204,73304,126806,15917,534,755,496,3170,11614,32434,87587,12873,57993,7647,38177,12169,74900,327
LA ED,Tangipahoa,Louisiana,22105,-90.40164948,30.64156055,85709,109.46,29663,41011,44698,60601,24527,180,242,159,951,6649,19274,50251,9535,33640,3977,21564,8099,52200,214
LA ED,Terrebonne,Louisiana,22109,-90.85712051,29.45525646,96982,70.95,31837,47483,49499,75082,16032,4905,692,271,1376,8400,22984,57524,8074,35416,3579,23293,8544,52900,250
LA ED,Washington,Louisiana,22117,-90.03277206,30.83641243,43185,63.88,15475,20841,22344,29669,13376,59,53,28,239,3012,9407,24570,6196,17617,2142,11817,3658,37900,155
LA MD,Ascension,Louisiana,22005,-90.86888123,30.21381283,58214,196.67,19337,28551,29663,44480,13268,90,161,215,923,4951,13700,34935,4628,21165,1828,15147,4190,61000,218
LA MD,East Baton Rouge,Louisiana,22033,-91.07601547,30.52279949,380105,829.92,138620,182318,197787,240614,132328,615,5351,1197,5761,29225,75356,240639,34885,156767,18147,83168,55452,69200,287
LA MD,East Feliciana,Louisiana,22037,-91.07001495,30.82737541,19211,42.22,5589,10004,9207,10022,9083,23,22,61,186,1516,4211,11412,2072,6476,887,4463,1126,46700,149
LA MD,Iberville,Louisiana,22047,-91.35349274,30.26629257,31049,48.67,9875,15042,16007,16519,14385,56,49,40,598,2535,6705,18419,3390,11352,1477,7385,2490,50800,155
LA MD,Livingston,Louisiana,22063,-90.71427536,30.42300034,70526,106.7,23814,34931,35595,66269,3920,160,120,57,642,5657,16519,42574,5776,26848,3034,19585,4229,56900,228
LA MD,Pointe Coupee,Louisiana,22077,-91.66879447,30.75627136,22540,39.82,7736,10833,11707,13196,9275,29,14,26,166,1753,5078,12816,2893,9695,1959,5732,2004,48300,130
LA MD,St. Helena,Louisiana,22091,-90.73429489,30.82751846,9874,24.14,3328,4730,5144,4725,5127,12,2,8,46,865,2245,5556,1208,3840,512,2807,521,40000,130
LA MD,West Baton Rouge,Louisiana,22121,-91.31190872,30.4946022,19419,100.1,6606,9423,9996,12329,6993,37,25,35,206,1568,4211,11871,1769,7298,692,5017,1589,58400,220
LA MD,West Feliciana,Louisiana,22125,-91.46145248,30.85909367,12915,31.81,2741,8773,4142,5672,7149,51,12,31,203,667,1882,9479,887,3392,651,1869,872,61300,164
LA WD,Acadia,Louisiana,22001,-92.37825775,30.27512074,55882,85.06,19285,26596,29286,45532,10179,48,75,48,372,4774,13106,31376,6626,21441,2156,13752,5533,40600,148
LA WD,Allen,Louisiana,22003,-92.85262299,30.66481209,21226,27.75,7080,10732,10494,16308,4496,297,39,86,671,1598,4510,12382,2736,8275,1195,5504,1576,35400,138
LA WD,Avoyelles,Louisiana,22009,-91.97566605,31.09515667,39159,46.29,13480,18860,20299,28324,10585,105,45,100,621,3019,8485,21798,5857,15428,1948,10085,3395,34900,118
LA WD,Beauregard,Louisiana,22011,-93.35541534,30.64695644,30083,25.87,10362,15153,14930,25242,4489,121,139,92,417,2342,6447,18002,3292,12666,2304,7973,2389,45100,221
LA WD,Bienville,Louisiana,22013,-93.09901428,32.37072182,15979,19.58,5852,7618,8361,8986,6949,23,12,9,81,1189,3324,8541,2925,7085,1233,4600,1252,33600,111
LA WD,Bossier,Louisiana,22015,-93.61207199,32.63101387,86088,101.88,30718,41831,44257,67030,17381,308,908,461,1799,7246,17938,53109,7795,34994,4276,20477,10241,61000,289
LA WD,Caddo,Louisiana,22017,-93.7641716,32.6113224,248253,277.69,93248,115934,132319,146580,99511,557,1115,490,2595,19545,51354,144279,33075,107615,14367,60067,33181,55500,264
LA WD,Calcasieu,Louisiana,22019,-93.31787872,30.27074432,168134,155.39,60328,81640,86494,128181,38445,387,590,531,1847,13109,36026,100776,18223,66426,6098,42452,17876,54700,248
LA WD,Caldwell,Louisiana,22021,-92.08640671,32.10697651,9810,18.13,3575,4786,5024,7970,1760,11,12,57,160,706,2125,5498,1481,4533,958,2868,707,34900,135
LA WD,Cameron,Louisiana,22023,-93.25350952,29.82446194,9260,6.53,3153,4612,4648,8685,503,15,26,31,143,791,2048,5496,925,5031,1878,2683,470,44500,199
LA WD,Catahoula,Louisiana,22025,-91.91390783,31.60338402,11065,15.12,3927,5359,5706,8136,2874,16,5,34,71,872,2514,6194,1485,5138,1211,3201,726,31600,112
LA WD,Claiborne,Louisiana,22027,-92.97472763,32.80248642,17405,22.75,6065,8826,8579,9313,8041,28,13,10,40,1188,3258,9883,3076,7513,1448,4575,1490,35800,100
LA WD,Concordia,Louisiana,22029,-91.60916138,31.37844944,20828,29.05,7341,9878,10950,13164,7596,29,24,15,130,1571,4804,11854,2599,9043,1702,5481,1860,39600,125
LA WD,De Soto,Louisiana,22031,-93.69193268,32.09886074,25346,28.8,9129,12014,13332,14003,11141,61,9,132,377,2033,5517,14120,3676,10919,1790,6964,2165,39400,134
LA WD,East Carroll,Louisiana,22035,-91.22569656,32.7775116,9709,22.79,3129,4567,5142,3355,6291,4,20,39,120,930,2570,4876,1333,3563,434,1923,1206,30700,99
LA WD,Evangeline,Louisiana,22039,-92.39311981,30.74397373,33274,49.89,11795,15928,17346,24405,8701,31,38,99,270,2855,7635,18356,4428,13311,1516,8201,3594,32700,122
LA WD,Franklin,Louisiana,22041,-91.68492889,32.14498043,22387,35.26,7776,10583,11804,15278,7040,31,27,11,120,1714,5166,12078,3429,8719,943,5881,1895,34100,131
LA WD,Grant,Louisiana,22043,-92.57872391,31.5973177,17526,26.84,6261,8456,9070,14860,2540,79,30,17,153,1391,3833,9912,2390,7494,1233,5055,1206,39400,165
LA WD,Iberia,Louisiana,22045,-91.8097717,29.92784405,68297,115.95,22847,32941,35356,46940,20154,135,843,225,1320,6006,15934,39110,7247,25472,2625,16231,6616,49700,189
LA WD,Jackson,Louisiana,22049,-92.55815125,32.32596588,15705,27.12,5817,7494,8211,11065,4589,24,19,8,50,1063,3406,8595,2641,7041,1224,4519,1298,37900,126
LA WD,Jefferson Davis,Louisiana,22053,-92.85403061,30.26921654,30722,46.9,10669,14805,15917,24721,5836,65,44,56,201,2484,7077,17248,3913,11963,1294,7971,2698,40700,162
LA WD,La Salle,Louisiana,22059,-92.18659973,31.6293087,13662,21.41,5086,6474,7188,12271,1257,80,36,18,46,904,2846,7776,2136,5969,883,4177,909,34300,148
LA WD,Lafayette,Louisiana,22055,-92.09035873,30.21537209,164762,610.23,60411,79848,84914,125340,36846,362,1594,620,2613,13934,33961,103149,13718,67431,7020,37031,23380,62700,245
LA WD,Lincoln,Louisiana,22061,-92.64331436,32.60881615,41745,88.44,13669,20231,21514,24620,16590,42,350,143,381,2605,6989,27665,4486,15286,1617,8491,5178,56200,243
LA WD,Madison,Louisiana,22065,-91.21203613,32.38964081,12463,19.75,4252,5757,6706,4961,7415,15,9,63,126,1086,3246,6396,1735,4823,571,2732,1520,30100,99
LA WD,Morehouse,Louisiana,22067,-91.75256348,32.76560783,31938,39.58,10961,15021,16917,18584,13263,30,44,17,136,2463,7344,17457,4674,12314,1353,8086,2875,36100,156
LA WD,Natchitoches,Louisiana,22069,-93.0759201,31.7506361,36689,29.03,12644,17359,19330,22357,13779,175,148,230,487,2805,8171,20924,4789,15210,2566,8474,4170,46600,194
LA WD,Ouachita,Louisiana,22073,-92.15675735,32.4974308,142191,226.78,50518,67060,75131,96870,44096,239,740,246,1194,11410,30336,84419,16026,56300,5782,32724,17794,52800,235
LA WD,Rapides,Louisiana,22079,-92.52209091,31.20502853,131556,98.1,45941,63037,68519,92989,36805,564,908,290,1526,10102,28096,77533,15825,51239,5298,30537,15404,52600,244
LA WD,Red River,Louisiana,22081,-93.35890579,32.06737518,9387,23.82,3321,4440,4947,5752,3589,18,6,22,61,791,2134,5007,1455,3839,518,2510,811,35500,144
LA WD,Richland,Louisiana,22083,-91.73329544,32.41887283,20629,36.64,7079,9667,10962,13020,7539,15,13,42,199,1584,4750,11073,3222,8031,952,5214,1865,36800,125
LA WD,Sabine,Louisiana,22085,-93.55131149,31.51112652,22646,26.49,8361,11008,11638,17939,3984,639,24,60,1031,1740,4714,12447,3745,12789,4428,6695,1666,37800,139
LA WD,St. Landry,Louisiana,22097,-92.08231735,30.57936859,80331,85.82,27477,38242,42089,47532,32392,68,174,165,639,6737,18790,44895,9909,31137,3660,19725,7752,40500,147
LA WD,St. Martin,Louisiana,22099,-91.53493881,30.11147308,43978,58.72,14634,21352,22626,28806,14532,78,321,241,502,3935,10300,25638,4105,17592,2958,11697,2937,44400,160
LA WD,St. Mary,Louisiana,22101,-91.46876907,29.72441864,58086,94.76,19456,28371,29715,37688,18337,838,998,225,1128,5140,13558,33860,5528,21884,2428,13348,6108,49200,193
LA WD,Tensas,Louisiana,22107,-91.28521347,32.00322247,7103,11.4,2515,3242,3861,3292,3785,12,4,10,43,571,1733,3602,1197,3334,819,1802,713,34100,99
LA WD,Union,Louisiana,22111,-92.38157272,32.80152512,20690,23.4,7528,9928,10762,14850,5767,18,25,30,133,1500,4302,11674,3214,9304,1776,6196,1332,39600,144
LA WD,Vermilion,Louisiana,22113,-92.3404541,29.84759712,50055,41.54,17762,24254,25801,42237,6956,82,679,101,592,3998,11379,28097,6581,20361,2599,13447,4315,43800,169
LA WD,Vernon,Louisiana,22115,-93.19387436,31.11769581,61961,46.52,19111,34054,27907,45828,12867,445,1502,1319,3405,6538,11585,40242,3596,21622,2511,9637,9474,47800,268
LA WD,Webster,Louisiana,22119,-93.33292389,32.71616364,41989,69.75,15849,19870,22119,28550,13277,79,52,31,229,2996,8477,23704,6812,18365,2516,11738,4111,40600,171
LA WD,West Carroll,Louisiana,22123,-91.44128418,32.79975319,12093,33.59,4394,5780,6313,9997,2020,35,6,35,115,874,2652,6643,1924,4831,437,3413,981,30400,125
LA WD,Winn,Louisiana,22127,-92.63859177,31.93318367,16269,17.07,5787,8053,8216,11343,4798,67,23,38,139,1182,3344,9267,2476,7006,1219,4412,1375,34000,128
MA D,Barnstable,Massachusetts,25001,-69.97249141,41.80604362,186605,466.51,77586,88136,98469,179551,2827,1180,968,2079,2287,11904,27326,106240,41135,135192,57606,56136,21450,162800,547
MA D,Berkshire,Massachusetts,25003,-73.22198105,42.39109802,139352,150,54315,66745,72607,135122,2534,242,1001,453,1407,8740,22949,84134,23529,64324,10009,35413,18902,114900,365
MA D,Bristol,Massachusetts,25005,-71.11220169,41.79232216,506325,909.02,187668,241819,264506,482426,8054,937,4478,10430,13578,35729,88152,309134,73310,201235,13567,110843,76825,141700,345
MA D,Dukes,Massachusetts,25007,-70.66555786,41.38630104,11639,114.11,5003,5648,5991,10979,332,253,44,31,121,826,1878,7102,1833,11604,6601,3569,1434,195800,521
MA D,Essex,Massachusetts,25009,-70.92722321,42.65727043,670080,1353.7,251285,319931,350149,616427,15809,1226,9909,26709,48440,48777,109800,416829,94674,271977,20692,153683,97602,176200,522
MA D,Franklin,Massachusetts,25011,-72.61997986,42.52492142,70092,99.85,27640,33952,36140,68617,476,206,484,309,842,5069,12235,42615,10173,30394,2754,18123,9517,114100,402
MA D,Hampden,Massachusetts,25013,-72.60374451,42.16960526,456310,738.37,169906,216968,239342,387805,34289,784,3886,29546,45785,33701,80161,275011,67437,180025,10119,102324,67582,123200,415
MA D,Hampshire,Massachusetts,25015,-72.63857651,42.3705349,146568,277.59,50052,69174,77394,137485,2552,267,4477,1787,3887,7977,20257,101337,16997,53068,3016,31160,18892,134700,461
MA D,Middlesex,Massachusetts,25017,-71.46431732,42.44005394,1398468,1701.3,519527,673201,725267,1287412,40236,1933,51826,17061,47383,90562,200430,932357,175119,543796,24269,309800,209727,192800,598
MA D,Nantucket,Massachusetts,25019,-70.00493801,41.31499863,6012,127.91,2597,3003,3009,5787,151,5,18,51,50,421,833,3939,819,7021,4424,1628,969,299400,670
MA D,Norfolk,Massachusetts,25021,-71.14357376,42.16547394,616087,1540.22,227798,292847,323240,582746,12089,787,17889,2576,8414,39774,89913,400088,86312,236816,9018,154171,73627,182900,612
MA D,Plymouth,Massachusetts,25023,-70.80845642,41.94612694,435276,664.54,149519,212568,222708,406699,16520,888,3452,7717,9571,33022,81255,270815,50184,168555,19036,109133,40386,156400,534
MA D,Suffolk,Massachusetts,25025,-71.07579803,42.33654404,663906,11647.47,264061,319031,344875,438550,149165,2087,33521,40583,72844,42721,85464,455225,80496,289276,25215,85880,178181,162100,546
MA D,Worcester,Massachusetts,25027,-71.89146805,42.36227989,709705,469.07,260153,345722,363983,665768,15096,1446,11439,15956,32940,53250,119949,439240,97266,279428,19275,159630,100523,140000,448
MD D,Allegany,Maryland,24001,-78.68783188,39.58121872,74946,178.02,29634,35274,39672,72955,1535,59,321,76,319,4365,12000,44701,13880,32513,2879,20719,8915,46700,216
MD D,Anne Arundel,Maryland,24003,-76.63382339,38.96838379,427239,1022.1,149114,215082,212157,365953,50525,1292,7675,1794,6815,31747,73441,284486,37565,157194,8080,108649,40465,127900,534
MD D,Baltimore,Maryland,24005,-76.63097,39.46453667,692134,1157.41,268280,330339,361795,587898,85451,1468,15544,1773,8131,47280,103882,444123,96849,281553,13273,177994,90286,99900,458
MD D,Baltimore City,Maryland,24510,-76.62197876,39.28352547,736014,9200.18,276484,343513,392501,287753,435768,2555,7942,1996,7602,56934,122935,455229,100916,303706,27222,134424,142060,54700,321
MD D,Calvert,Maryland,24009,-76.54369354,38.54302597,51372,241.18,16986,25487,25885,42825,8046,127,292,82,502,4066,10534,32190,4582,18974,1988,14431,2555,136100,519
MD D,Caroline,Maryland,24011,-75.86437225,38.89554977,27035,84.22,9983,13115,13920,22355,4459,58,79,84,231,2057,5043,16045,3890,10745,762,7338,2645,75000,256
MD D,Carroll,Maryland,24013,-77.05043793,39.52646065,123372,272.95,42248,60749,62623,119336,2933,192,747,164,903,9625,23145,78045,12557,43553,1305,33164,9084,126700,397
MD D,Cecil,Maryland,24015,-76.00307083,39.55144691,71347,198.19,24725,35622,35725,67450,3240,150,310,197,635,5608,13900,44474,7365,27656,2931,18534,6191,97000,364
MD D,Charles,Maryland,24017,-76.97620773,38.50191689,101154,223.79,32950,50249,50905,80234,18419,761,1338,402,1705,8617,21139,64825,6573,34487,1537,24957,7993,122300,603
MD D,Dorchester,Maryland,24019,-76.00084686,38.47983551,30236,50.99,12117,14324,15912,21548,8423,51,138,76,177,2028,4889,18093,5226,14269,2152,8193,3924,68600,228
MD D,Frederick,Maryland,24021,-77.39636993,39.4696064,150208,226.56,52570,73955,76253,139909,8010,284,1510,495,1713,11902,27829,96268,14209,54872,2302,37227,15343,129500,487
MD D,Garrett,Maryland,24023,-79.21025848,39.4597702,28138,42.83,10110,13721,14417,27963,105,22,40,8,110,1951,5669,16651,3867,14119,4009,7998,2112,60200,230
MD D,Harford,Maryland,24025,-76.32498932,39.54831886,182132,406.54,63193,90936,91196,162559,15530,490,2503,1050,2821,14761,34021,118316,15034,66446,3253,46704,16489,114700,403
MD D,Howard,Maryland,24027,-76.9425087,39.23057747,187328,746.33,68337,93252,94076,155899,22019,402,8098,910,3699,15200,33282,127447,11399,72583,4246,49352,18985,166500,614
MD D,Kent,Maryland,24029,-76.09689616,39.23926163,17842,64.18,6702,8629,9213,14085,3534,29,68,126,467,1104,2701,11018,3019,8181,1479,4797,1905,87700,313
MD D,Montgomery,Maryland,24031,-77.20315933,39.13972855,757027,1529.35,282228,364880,392147,580635,92267,1841,61981,20303,55684,57138,121106,501292,77491,295723,13495,191749,90479,200800,698
MD D,Prince Georges,Maryland,24033,-76.88241196,38.83034134,729268,1497.47,258011,353423,375845,314616,369791,2339,28255,14267,29983,55409,122536,500980,50343,270090,12079,151869,106142,122600,607
MD D,Queen Annes,Maryland,24035,-76.06424332,39.06155968,33953,91.27,12489,16789,17164,29911,3839,45,125,33,189,2463,5878,21241,4371,13944,1455,10119,2370,118000,350
MD D,Somerset,Maryland,24039,-75.72145462,38.13181305,23440,69.35,7977,12424,11016,14282,8943,47,96,72,229,1234,3493,15209,3504,9393,1416,5758,2219,55600,230
MD D,St. Marys,Maryland,24037,-76.5971756,38.27948952,75974,203.68,25500,38674,37300,64129,10275,268,928,374,1230,6794,14759,48121,6300,27863,2363,17775,7725,109100,447
MD D,Talbot,Maryland,24041,-76.12593842,38.76002693,30549,117.95,12677,14491,16058,24833,5502,42,102,70,167,1939,4494,17988,6128,14697,2020,8636,4041,118100,340
MD D,Washington,Maryland,24043,-77.72072697,39.52153206,121393,266.8,44762,61275,60118,112828,7245,241,793,286,905,8093,19443,77066,16791,47448,2686,28577,16185,83000,297
MD D,Wicomico,Maryland,24045,-75.60586166,38.40817451,74339,196.15,27772,35614,38725,56755,16573,137,671,203,610,5215,12895,46670,9559,30108,2336,18535,9237,71100,349
MD D,Worcester,Maryland,24047,-75.35438156,38.22581291,35028,73.74,14142,16854,18174,27253,7467,72,163,73,275,2288,5409,21267,6064,41800,27658,9797,4345,83500,296
ME D,Androscoggin,Maine,23001,-70.23722839,44.20212555,105259,220.67,40017,50914,54345,103687,485,233,557,297,780,7768,19387,63979,14125,43815,3798,24906,15111,86800,334
ME D,Aroostook,Maine,23003,-68.30337454,46.51265144,86936,12.93,31366,43924,43012,84601,932,793,405,205,554,6055,16297,53457,11127,38421,7055,21810,9556,45900,267
ME D,Cumberland,Maine,23005,-70.36534882,43.85161781,243135,277.55,94512,116860,126275,238403,1565,628,2147,392,1560,16907,40021,154490,31717,109890,15378,60812,33700,118300,458
ME D,Franklin,Maine,23007,-70.38273621,45.06344223,29008,17.07,10778,13982,15026,28785,30,86,81,26,110,2003,5596,17839,3570,17280,6502,8151,2627,66200,278
ME D,Hancock,Maine,23009,-68.40245438,44.74045181,46948,30.55,18342,23011,23937,46471,98,171,138,70,266,3205,8130,28458,7155,30396,12054,13876,4466,85200,325
ME D,Kennebec,Maine,23011,-69.74709702,44.41528893,115904,132.31,43889,55888,60016,114624,266,379,501,134,516,7802,21450,71108,15544,51648,7759,31098,12791,79300,330
ME D,Knox,Maine,23013,-69.23342514,44.15360641,36310,98.14,14344,17603,18707,36039,56,111,79,25,142,2432,6432,21278,6168,19009,4665,10564,3780,92500,333
ME D,Lincoln,Maine,23015,-69.54176712,44.09314537,30357,66.28,11968,14787,15570,30185,23,89,39,21,126,2012,5609,17712,5024,17538,5570,9955,2013,103000,356
ME D,Oxford,Maine,23017,-70.65987778,44.56263733,52602,25.62,20064,25624,26978,52267,67,98,136,34,206,3792,10084,30800,7926,29689,9625,15262,4802,69900,281
ME D,Penobscot,Maine,23019,-68.64536285,45.5208683,146601,42.74,54063,71639,74962,143678,536,1273,932,182,701,9601,26010,94030,16960,61359,7296,37679,16384,69100,335
ME D,Piscataquis,Maine,23021,-69.29401398,45.79236603,18653,4.68,7194,9100,9553,18493,20,75,58,7,69,1141,3739,10762,3011,13194,6000,5654,1540,46800,250
ME D,Sagadahoc,Maine,23023,-69.87178802,43.95050049,33535,130.49,12581,16552,16983,32783,336,78,249,89,337,2731,6206,20872,3726,14633,2052,8909,3672,95900,416
ME D,Somerset,Maine,23025,-69.90949631,45.57390404,49767,12.66,18513,24356,25411,49393,64,159,111,40,172,3484,10162,29627,6494,24927,6414,14303,4210,56400,275
ME D,Waldo,Maine,23027,-69.15683365,44.49890518,33018,45.23,12415,16203,16815,32797,39,82,74,26,170,2354,6577,19776,4311,16181,3766,10028,2387,71500,283
ME D,Washington,Maine,23029,-67.53259659,45.06677818,35308,13.65,13418,17285,18023,33734,66,1414,81,13,127,2250,6790,20561,5707,19124,5706,10568,2850,53100,227
ME D,York,Maine,23031,-70.66352463,43.45392799,164587,163.28,61848,80122,84465,162420,555,329,1095,188,993,12185,30790,100804,20808,79941,18093,44313,17535,115200,429
MI ED,Alcona,Michigan,26001,-83.58501816,44.68543053,10145,14.94,4261,5048,5097,10026,27,56,26,10,55,515,1627,5560,2443,10414,6153,3683,578,48200,244
MI ED,Alpena,Michigan,26007,-83.60096359,45.03448677,30605,53.98,11838,14845,15760,30372,35,93,85,20,145,2005,6061,17946,4593,14431,2593,9251,2587,41600,245
MI ED,Arenac,Michigan,26011,-83.86751938,44.04366302,14931,40.68,5642,7304,7627,14695,10,139,38,49,167,1000,2990,8522,2419,8891,3249,4595,1047,41800,252
MI ED,Bay,Michigan,26017,-83.93482208,43.74285889,111723,249.94,42188,54044,57679,107747,1242,726,428,1580,3494,7965,21414,67364,14980,44234,2046,32424,9764,44100,287
MI ED,Cheboygan,Michigan,26031,-84.47014999,45.49113846,21398,29.72,8201,10345,11053,20837,15,478,57,11,80,1444,4161,12077,3716,14090,5889,6522,1679,47400,250
MI ED,Clare,Michigan,26035,-84.85049057,43.992239,24952,43.78,9698,12069,12883,24665,40,160,53,34,132,1820,4715,14014,4403,19135,9437,7604,2094,36800,243
MI ED,Crawford,Michigan,26039,-84.61485672,44.68616104,12260,21.93,4441,6275,5985,11802,264,145,42,7,79,901,2300,7232,1827,8727,4286,3566,875,44500,273
MI ED,Genesee,Michigan,26049,-83.69400406,43.00453758,430459,670.5,161296,206003,224456,336651,84257,3132,2902,3517,8877,33436,87227,265967,43829,170808,9512,113585,47711,50500,328
MI ED,Gladwin,Michigan,26051,-84.3884964,43.99424553,21896,43.36,8357,10777,11119,21694,19,114,40,29,136,1567,4195,12321,3813,14885,6528,6816,1541,42700,226
MI ED,Gratiot,Michigan,26057,-84.60932922,43.298172,38982,68.39,13659,18946,20036,37827,328,144,98,585,1467,2699,7879,23056,5348,14699,1040,10407,3252,38800,253
MI ED,Huron,Michigan,26063,-83.036129,43.87035942,34951,42.11,13268,17111,17840,34627,22,89,60,153,372,2439,6938,19156,6418,19755,6487,10532,2736,44500,229
MI ED,Iosco,Michigan,26069,-83.60354996,44.34277344,30209,55.33,11588,15103,15106,28966,632,228,269,114,357,2519,5445,17701,4544,19517,7929,7923,3665,47400,278
MI ED,Isabella,Michigan,26073,-84.85062027,43.64385986,54624,94.67,17591,26110,28514,52212,635,1020,456,301,714,3548,8978,37522,4576,19950,2359,11431,6160,53200,326
MI ED,Jackson,Michigan,26075,-84.42974472,42.25123978,149756,212.42,53660,76067,73689,135557,11983,655,653,908,2303,10936,27631,92632,18557,57979,4319,39528,14132,47900,309
MI ED,Lapeer,Michigan,26087,-83.22177505,43.10716438,74768,113.63,24659,37451,37317,73049,483,319,282,635,1493,5466,16643,46188,6471,26445,1786,19978,4681,62300,335
MI ED,Lenawee,Michigan,26091,-84.06453323,41.89606094,91476,121.48,31635,45098,46378,86323,1431,303,486,2933,5515,6644,19134,54639,11059,35104,3469,23996,7639,54000,316
MI ED,Livingston,Michigan,26093,-83.91147232,42.60588264,115645,201.47,38887,58386,57259,113566,673,705,480,221,974,8711,24421,73039,9474,41863,2976,32871,6016,97300,448
MI ED,Macomb,Michigan,26099,-82.91636658,42.67715836,717400,1488.38,264991,348545,368855,693686,10400,2639,9112,1563,7978,48914,122739,457290,88457,274843,9852,204609,60382,76800,437
MI ED,Midland,Michigan,26111,-84.39021683,43.64874458,75651,144.1,27791,37359,38292,73466,719,334,804,328,1035,5697,15011,47403,7540,29343,1552,21383,6408,63300,344
MI ED,Monroe,Michigan,26115,-83.48338318,41.90538979,133600,239.86,46508,65849,67751,129421,2339,481,574,785,2077,10226,28018,81529,13827,48312,1804,36178,10330,67200,344
MI ED,Montmorency,Michigan,26119,-84.12654877,45.0302906,8936,16.25,3600,4377,4559,8861,1,48,10,16,60,520,1580,4792,2044,8791,5191,2935,665,41700,223
MI ED,Oakland,Michigan,26125,-83.38788605,42.66469383,1083592,1238.39,410488,526927,556665,970674,77488,3948,25103,6379,19630,78224,189834,697646,117888,432684,22196,298377,112111,95400,495
MI ED,Ogemaw,Michigan,26129,-84.12980652,44.3397522,18681,32.77,7190,9196,9485,18489,18,140,19,15,104,1259,3666,10366,3390,13977,6787,5850,1340,39500,241
MI ED,Oscoda,Michigan,26135,-84.13139725,44.68451309,7842,13.81,3160,3863,3979,7781,2,41,5,13,50,534,1352,4340,1616,8112,4952,2588,572,37400,230
MI ED,Otsego,Michigan,26137,-84.6160965,45.03207588,17957,34.8,6522,8823,9134,17737,18,103,82,17,67,1387,3731,10406,2433,10669,4147,5157,1365,56000,292
MI ED,Presque Isle,Michigan,26141,-83.82156754,45.41648865,13743,20.95,5376,6784,6959,13648,11,43,30,11,37,854,2649,7524,2716,8917,3541,4498,878,44000,207
MI ED,Roscommon,Michigan,26143,-84.61343384,44.34036446,19776,37.45,8516,9672,10104,19597,37,101,23,18,94,1070,3103,10670,4933,19881,11365,6978,1538,44500,248
MI ED,Saginaw,Michigan,26145,-84.03157043,43.35064507,211946,260.06,78256,100988,110958,165430,36849,915,1272,7480,13186,16428,43149,126766,25603,81931,3675,55304,22952,48100,301
MI ED,Sanilac,Michigan,26151,-82.81042862,43.42769814,39928,41.42,14658,19578,20350,39232,39,195,71,391,905,2966,8327,22412,6223,19465,4807,11643,3015,42400,254
MI ED,Shiawassee,Michigan,26155,-84.1473732,42.95637321,69770,129.2,24864,34025,35745,68686,93,397,223,371,1053,5134,14801,42067,7768,25833,969,19321,5543,47200,292
MI ED,St. Clair,Michigan,26147,-82.70608902,42.90196037,145607,198.37,52882,70858,74749,140294,2987,745,475,1106,2558,11043,29368,87277,17919,57494,4612,40015,12867,59400,329
MI ED,Tuscola,Michigan,26157,-83.40231323,43.48613739,55498,68.35,19469,27548,27950,54051,478,345,206,418,1150,3954,11872,32976,6696,21231,1762,15817,3652,46000,268
MI ED,Washtenaw,Michigan,26161,-83.84062576,42.25654602,282937,398.5,104528,139917,143020,236390,31720,1076,11724,2027,5731,19160,41936,200615,21226,111256,6728,57787,46741,96000,490
MI ED,Wayne,Michigan,26163,-83.2153511,42.24598312,2111687,3433.64,780535,1001026,1110661,1212007,849109,8048,21704,20819,50506,170851,399786,1276548,264502,832710,52175,498682,281853,48500,297
MI WD,Alger,Michigan,26003,-86.48395538,46.42793274,8972,9.84,3337,4610,4362,8422,213,304,24,9,43,549,1691,5183,1549,5775,2438,2671,666,39200,206
MI WD,Allegan,Michigan,26005,-85.91497803,42.59854889,90509,108.78,31709,44815,45694,86760,1448,543,411,1347,2895,7494,19371,53219,10425,36395,4686,25592,6117,59300,305
MI WD,Antrim,Michigan,26009,-85.1516037,45.01254082,18185,37.89,6980,8890,9295,17895,23,211,24,32,96,1254,3423,10346,3162,13145,6165,5648,1332,53000,274
MI WD,Baraga,Michigan,26013,-88.32817078,46.68434715,7954,8.83,3065,3999,3955,6971,49,918,10,6,34,532,1574,4294,1554,4684,1619,2265,800,37900,181
MI WD,Barry,Michigan,26015,-85.31172562,42.5991478,50057,89.39,17763,25032,25025,49429,104,188,144,192,521,3694,10295,30219,5849,20887,3124,14929,2834,54700,287
MI WD,Benzie,Michigan,26019,-86.03674316,44.64646912,12200,37.89,4772,6019,6181,11863,30,237,35,35,129,848,2108,7146,2098,8557,3785,3906,866,50200,250
MI WD,Berrien,Michigan,26021,-86.53079605,42.00710106,161378,280.17,61025,77324,84054,133259,24872,685,1487,1075,2683,11895,31624,95714,22145,69532,8507,42452,18573,52800,294
MI WD,Branch,Michigan,26023,-85.06309509,41.91852379,41502,81.7,14921,20303,21199,40278,705,221,156,142,468,3200,8367,24424,5511,18449,3528,11351,3570,40800,265
MI WD,Calhoun,Michigan,26025,-85.00940323,42.2510891,135982,190.99,51812,65788,70194,118737,14383,696,1068,1098,2583,10011,26182,81629,18160,55619,3807,36806,15006,42700,303
MI WD,Cass,Michigan,26027,-85.99856186,41.91903687,49477,99.75,18239,24280,25197,44827,3725,469,191,265,651,3504,9861,29635,6477,22644,4405,14399,3840,48600,266
MI WD,Charlevoix,Michigan,26029,-85.06138229,45.24383926,21468,50.99,8243,10519,10949,20993,17,378,41,39,112,1621,4171,12591,3085,13119,4876,6354,1889,53600,288
MI WD,Chippewa,Michigan,26033,-84.35265732,46.34420395,34604,21.76,11541,19192,15412,28353,2184,3820,152,95,278,2100,5980,22185,4339,18023,6482,8472,3069,37500,259
MI WD,Clinton,Michigan,26037,-84.60338974,42.94932556,57883,101.02,20212,28812,29071,56639,218,276,199,551,1286,4333,12319,35841,5390,20959,747,16785,3427,68000,326
MI WD,Delta,Michigan,26041,-86.9096756,45.85823441,37780,32.21,14531,18402,19378,36819,16,809,99,37,136,2513,7661,21804,5802,17928,3397,11066,3465,43200,233
MI WD,Dickinson,Michigan,26043,-87.87000275,45.98555946,26831,34.85,10633,13165,13666,26532,23,135,106,35,116,1821,5151,14951,4908,12902,2269,8445,2188,42900,276
MI WD,Eaton,Michigan,26045,-84.84237289,42.5992775,92879,160.41,34027,45114,47765,87549,3310,438,559,1023,2199,6600,19029,58033,9217,35517,1490,24814,9213,68200,376
MI WD,Emmet,Michigan,26047,-84.92226028,45.52933693,25040,53.5,9516,12150,12890,24122,133,683,69,33,118,1880,4797,14832,3531,14731,5215,7057,2459,64700,324
MI WD,Gogebic,Michigan,26053,-89.69659424,46.43471336,18052,16.34,7449,8866,9186,17486,243,283,26,14,67,1026,3005,9698,4323,10997,3548,5822,1627,23300,187
MI WD,Grand Traverse,Michigan,26055,-85.57658386,44.68683052,64273,137.92,23965,31303,32970,63019,259,555,318,122,503,4856,12556,38971,7890,28740,4775,17922,6043,66700,377
MI WD,Hillsdale,Michigan,26059,-84.59638977,41.8876133,43431,72.02,15637,21309,22122,42919,113,143,112,144,395,3334,8922,25464,5711,18547,2910,12071,3566,41400,251
MI WD,Houghton,Michigan,26061,-88.71417236,46.82210541,35446,34.96,13172,18689,16757,34469,158,153,610,56,164,2115,5827,21168,6336,17296,4124,9155,4017,28300,230
MI WD,Ingham,Michigan,26065,-84.37399673,42.60294724,281912,503.41,102648,135397,146515,237183,27837,1941,7562,7389,13478,20798,47567,189171,24376,108542,5894,59942,42706,61800,374
MI WD,Ionia,Michigan,26067,-85.07576752,42.94975853,57024,98.83,18447,30414,26610,53141,3003,221,120,539,1176,4392,11712,35177,5743,19674,1227,14251,4196,47700,272
MI WD,Iron,Michigan,26071,-88.54928207,46.17525291,13175,11.33,5655,6311,6864,13028,4,102,32,9,67,709,2221,6679,3566,9039,3384,4532,1123,30100,191
MI WD,Kalamazoo,Michigan,26077,-85.5345993,42.25095558,223411,397.53,83702,107564,115847,197427,19879,1017,3168,1920,3950,16312,38161,145214,23724,88955,5253,53869,29833,62800,372
MI WD,Kalkaska,Michigan,26079,-85.09406662,44.68713188,13497,23.97,4934,6762,6735,13321,10,114,23,29,87,1034,2920,7746,1797,9151,4217,3974,960,44500,269
MI WD,Kent,Michigan,26081,-85.55579758,43.0348053,500631,580.78,181740,242408,258223,444112,40314,2756,5380,8069,14684,43731,97845,305048,54007,192698,10958,126627,55113,68200,381
MI WD,Keweenaw,Michigan,26083,-88.84957886,47.99905205,1701,3.13,777,832,869,1688,1,4,6,2,6,84,255,862,500,2257,1480,672,105,19200,146
MI WD,Lake,Michigan,26085,-85.80368423,43.99393463,8583,15.11,3536,4203,4380,7337,1146,81,9,10,60,578,1577,4593,1835,12114,8578,2856,680,29800,204
MI WD,Leelanau,Michigan,26089,-85.72034801,44.98512459,16527,48.47,6274,8236,8291,15958,16,451,45,57,188,1247,3063,9751,2466,11171,4897,5111,1163,73100,322
MI WD,Luce,Michigan,26095,-85.54454422,46.50141525,5763,6.38,2154,2828,2935,5418,2,331,6,6,27,376,1192,3201,994,3594,1440,1704,450,30800,233
MI WD,Mackinac,Michigan,26097,-84.98607635,46.05139732,10674,10.41,4240,5284,5390,8955,5,1691,11,12,33,729,2037,6092,1816,9254,5014,3222,1018,43900,221
MI WD,Manistee,Michigan,26101,-86.1028862,44.34626389,21265,39.16,8580,10290,10975,20851,54,189,54,117,323,1317,3784,12267,3897,13330,4750,6707,1873,40400,224
MI WD,Marquette,Michigan,26103,-87.61214828,46.44954109,70887,38.93,25435,35986,34901,68027,1170,943,538,209,566,5042,13357,44510,7978,31049,5614,16332,9103,44800,273
MI WD,Mason,Michigan,26105,-86.2791214,44.00047493,25537,51.69,9984,12436,13101,24957,155,188,75,162,399,1785,4926,14454,4372,14119,4135,7576,2408,43300,243
MI WD,Mecosta,Michigan,26107,-85.32640457,43.64312935,37308,66.62,12260,19241,18067,35739,978,258,187,146,389,2294,5889,24935,4190,17274,5014,8564,3696,49100,280
MI WD,Menominee,Michigan,26109,-87.57204056,45.54898262,24920,23.85,9766,12294,12626,24464,7,382,60,7,59,1579,5010,14036,4295,12509,2743,7709,2057,37900,222
MI WD,Missaukee,Michigan,26113,-85.09545135,44.34069061,12147,21.5,4389,5990,6157,12015,3,74,25,30,67,937,2666,6732,1812,7112,2723,3641,748,40500,250
MI WD,Montcalm,Michigan,26117,-85.19981003,43.29901123,53059,74.42,18563,27041,26018,51216,960,384,157,342,888,4105,11096,31278,6580,22817,4254,14746,3817,42600,262
MI WD,Muskegon,Michigan,26121,-86.12968063,43.2980938,158983,313.58,57798,77648,81335,133931,21617,1338,555,1542,3623,12854,31810,93521,20798,61962,4164,43011,14787,46300,294
MI WD,Newaygo,Michigan,26123,-85.8014946,43.55687904,38202,45.1,13776,18789,19413,36758,468,248,103,625,968,3199,8093,21706,5204,20105,6329,11330,2446,44300,266
MI WD,Oceana,Michigan,26127,-86.2901535,43.64399719,22454,41.5,8071,11027,11427,21211,58,242,50,893,1390,1769,4873,12737,3075,12857,4786,6480,1591,43300,240
MI WD,Ontonagon,Michigan,26131,-89.37206268,46.68296242,8854,6.75,3641,4504,4350,8723,4,109,15,3,35,536,1573,5025,1720,5332,1691,2949,692,28100,192
MI WD,Osceola,Michigan,26133,-85.32769394,43.99311447,20146,35.41,7347,9981,10165,19899,57,117,43,30,143,1525,4448,11359,2814,11444,4097,5870,1477,37500,228
MI WD,Ottawa,Michigan,26139,-86.02983856,42.98950386,187768,331.16,62664,92572,95196,179675,997,638,2451,4007,7947,16013,39065,114216,18474,66624,3960,50576,12088,74600,402
MI WD,Schoolcraft,Michigan,26153,-86.23420334,46.13531876,8302,7.08,3294,3985,4317,7755,7,519,13,8,32,504,1626,4636,1536,5487,2193,2537,757,32300,206
MI WD,St. Joseph,Michigan,26149,-85.54823303,41.91871643,58913,117.12,21579,28802,30111,56661,1600,226,258,168,546,4621,12357,34241,7694,24242,2663,16143,5436,44800,278
MI WD,Van Buren,Michigan,26159,-86.06983185,42.24800491,70060,114.66,25402,34228,35832,63189,4690,646,217,1318,2254,5401,14995,40810,8854,31530,6128,19482,5920,48000,266
MI WD,Wexford,Michigan,26165,-85.57752609,44.34119225,26360,46.57,9923,12830,13530,26040,34,178,87,21,153,2067,5498,15164,3631,12862,2939,7414,2509,41200,279
MN D,Aitkin,Minnesota,27001,-93.43064499,46.59178734,12425,6.77,5126,6164,6261,12194,13,175,30,13,35,670,2289,6538,2928,12934,7808,4302,824,48600,186
MN D,Anoka,Minnesota,27003,-93.26855087,45.22511673,243641,566.61,82437,121989,121652,236791,1289,1865,2934,762,2269,21416,52953,155706,13566,85519,3082,66971,15466,83500,460
MN D,Becker,Minnesota,27005,-95.68014526,46.93507957,27881,21.25,10477,13819,14062,25849,20,1861,101,50,120,2063,6045,15187,4586,15563,5086,8150,2327,49000,224
MN D,Beltrami,Minnesota,27007,-95.0093689,47.97981071,34384,13.72,11870,17011,17373,28409,100,5641,194,40,146,2872,7356,20160,3996,14670,2800,8680,3190,49200,264
MN D,Benton,Minnesota,27009,-94.0558548,45.68909645,30185,73.98,10935,14849,15336,29837,61,123,129,35,139,2641,6403,17627,3514,11521,586,7331,3604,60800,367
MN D,Big Stone,Minnesota,27011,-96.47501373,45.38478279,6285,12.65,2463,3009,3276,6237,4,26,15,3,23,441,1200,3156,1488,3192,729,1993,470,27000,169
MN D,Blue Earth,Minnesota,27013,-94.0739975,44.05507088,54044,72.15,19277,26762,27282,52648,251,132,804,209,480,3425,8966,35067,6586,20358,1081,12328,6949,59500,332
MN D,Brown,Minnesota,27015,-94.74008942,44.3024826,26984,44.24,10321,13068,13916,26791,12,15,102,64,151,1973,5424,14834,4753,10814,493,7979,2342,48900,219
MN D,Carlton,Minnesota,27017,-92.67336273,46.59105682,29259,33.86,10842,14447,14812,27825,43,1297,75,19,99,2050,6161,16543,4505,12342,1500,8798,2044,45200,230
MN D,Carver,Minnesota,27019,-93.76921844,44.8092041,47915,136.51,16601,24089,23826,47167,103,112,444,89,252,4561,9946,29395,4013,17449,848,13117,3484,95700,409
MN D,Cass,Minnesota,27021,-94.28285599,46.87799644,21791,10.72,8302,10952,10839,19309,39,2373,54,16,94,1534,4395,11679,4183,18863,10561,6882,1420,50500,202
MN D,Chippewa,Minnesota,27023,-95.64805984,44.95734596,13228,22.65,5245,6369,6859,13114,6,29,44,35,94,886,2695,6885,2762,5755,510,3955,1290,34200,192
MN D,Chisago,Minnesota,27025,-92.89090729,45.51564407,30521,73.19,10551,15350,15171,30188,65,125,90,53,137,2484,6920,17413,3704,11946,1395,8964,1587,72600,313
MN D,Clay,Minnesota,27027,-96.50633621,46.88831329,50422,48.07,17490,24187,26235,48562,166,553,410,731,1179,3541,9084,31815,5982,18546,1056,11948,5542,58600,296
MN D,Clearwater,Minnesota,27029,-95.3787117,47.58653069,8309,8.32,3064,4179,4130,7663,2,633,10,1,16,585,1834,4277,1613,4008,944,2500,564,29400,172
MN D,Cook,Minnesota,27031,-90.27881241,47.85773087,3868,2.74,1632,1928,1940,3570,5,271,20,2,14,261,675,2294,638,4312,2680,1250,382,55600,218
MN D,Cottonwood,Minnesota,27033,-95.16555405,44.02211761,12694,19.83,5060,6153,6541,12563,12,10,88,21,63,813,2492,6543,2846,5495,435,3925,1135,29600,176
MN D,Crow Wing,Minnesota,27035,-94.08403397,46.47750092,44249,43.9,17204,21438,22811,43637,95,313,136,68,174,3171,8757,24678,7643,29916,12712,13188,4016,54200,269
MN D,Dakota,Minnesota,27037,-93.03155136,44.71125412,275227,479.49,98293,136017,139210,264854,3411,893,4643,1426,4025,25535,56611,175606,17475,102707,4414,72598,25695,95900,503
MN D,Dodge,Minnesota,27039,-92.86598206,44.0223999,15731,35.83,5538,7772,7959,15530,12,29,57,103,164,1339,3610,8700,2082,5771,233,4482,1056,53000,234
MN D,Douglas,Minnesota,27041,-95.45290756,45.93322563,28674,44.59,10988,14075,14599,28465,14,74,100,21,78,2020,5760,15694,5200,14590,3602,8149,2839,56400,253
MN D,Faribault,Minnesota,27043,-93.94921875,43.67430115,16937,23.72,6772,8115,8822,16670,10,23,55,179,322,1057,3437,8774,3669,7416,644,5335,1437,32200,185
MN D,Fillmore,Minnesota,27045,-92.0920372,43.67301941,20777,24.1,7822,10263,10514,20657,7,40,49,24,71,1493,4288,10795,4201,8356,534,6109,1713,38000,189
MN D,Freeborn,Minnesota,27047,-93.35264969,43.6744957,33060,46.89,13029,16158,16902,32217,11,64,132,636,1076,2256,6274,18384,6146,13783,754,9993,3036,42800,232
MN D,Goodhue,Minnesota,27049,-92.6458931,44.45447159,40690,53.33,15198,20003,20687,40101,82,276,178,53,173,3003,8447,22776,6464,15936,738,11622,3576,63300,272
MN D,Grant,Minnesota,27051,-96.01191711,45.93223953,6246,11.42,2454,3017,3229,6215,3,15,12,1,7,400,1217,3133,1496,3178,724,1952,502,29100,161
MN D,Hennepin,Minnesota,27053,-93.46867371,45.01847649,1032431,1908.38,419060,499728,532703,922321,60114,14912,29588,5496,13978,77210,161599,676665,116957,443583,24523,265610,153450,91000,452
MN D,Houston,Minnesota,27055,-91.47682571,43.67341423,18497,32.8,6844,9165,9332,18364,25,48,54,6,37,1467,3845,10254,2931,7257,413,5451,1393,52400,233
MN D,Hubbard,Minnesota,27057,-94.92036819,47.10829735,14939,15.96,5781,7372,7567,14637,4,278,15,5,37,1027,3062,8186,2664,10042,4261,4804,977,48700,208
MN D,Isanti,Minnesota,27059,-93.2698822,45.57310867,25921,58.91,8810,12950,12971,25583,68,137,106,27,119,2047,6065,14931,2878,9693,883,7321,1489,64400,302
MN D,Itasca,Minnesota,27061,-93.73776245,47.46162796,40863,15.36,15461,20191,20672,39358,39,1343,87,36,143,2703,8855,22815,6490,22494,7033,12855,2606,44300,234
MN D,Jackson,Minnesota,27063,-95.1616478,43.67358971,11677,16.71,4560,5775,5902,11414,2,15,165,81,113,798,2338,6213,2328,5121,561,3477,1083,32100,174
MN D,Kanabec,Minnesota,27065,-93.2858696,45.94566345,12802,24.29,4753,6371,6431,12656,20,60,45,21,61,979,2906,7043,1874,6098,1345,3925,828,49200,256
MN D,Kandiyohi,Minnesota,27067,-95.00896835,45.15286636,38761,49.44,14298,19082,19679,37837,85,164,114,561,1363,2973,8064,21913,5811,16669,2371,10418,3880,56800,269
MN D,Kittson,Minnesota,27069,-96.81005859,48.769207,5767,5.22,2274,2833,2934,5732,0,5,10,20,46,409,1097,3010,1251,2865,591,1860,414,28000,167
MN D,Koochiching,Minnesota,27071,-93.75634766,48.28093338,16299,5.24,6025,8440,7859,15633,45,451,50,120,185,1032,3117,9713,2437,7825,1800,4695,1330,41800,252
MN D,Lac Qui Parle,Minnesota,27073,-96.09569168,45.0392952,8924,11.56,3505,4406,4518,8867,11,12,28,6,23,605,1754,4507,2058,3955,450,2765,740,26000,164
MN D,Lake,Minnesota,27075,-91.41127777,47.56669998,10415,5.07,4242,5183,5232,10332,3,61,16,3,32,625,1910,6060,1820,6776,2534,3516,726,39400,217
MN D,Lake of the Woods,Minnesota,27077,-94.88650894,48.8699913,4076,3.15,1576,2037,2039,4042,1,19,10,4,25,337,791,2255,693,3050,1474,1332,244,40900,185
MN D,Le Sueur,Minnesota,27079,-93.77503586,44.37164307,23239,52.11,8468,11557,11682,23077,13,50,63,36,123,1788,5077,12877,3497,9785,1317,6946,1522,57800,256
MN D,Lincoln,Minnesota,27081,-96.2685585,44.41347122,6890,12.81,2704,3360,3530,6857,2,9,9,13,26,364,1437,3352,1737,3050,346,2161,543,22900,142
MN D,Lyon,Minnesota,27083,-95.84312439,44.41371346,24789,34.72,9073,12138,12651,24424,66,63,122,114,214,1746,4993,14196,3854,9675,602,6207,2866,48200,246
MN D,Mahnomen,Minnesota,27087,-95.81240082,47.32676697,5044,9.02,1805,2540,2504,3833,1,1193,5,12,27,345,1229,2549,921,2505,700,1433,372,33900,132
MN D,Marshall,Minnesota,27089,-96.37527847,48.35898209,10993,6.25,4194,5566,5427,10889,2,50,14,38,113,695,2474,5810,2014,5049,855,3443,751,34600,161
MN D,Martin,Minnesota,27091,-94.55305862,43.67290115,22914,32.46,9129,11168,11746,22714,9,35,85,71,137,1589,4554,12225,4546,9847,718,6837,2292,40500,205
MN D,McLeod,Minnesota,27085,-94.25738144,44.80696487,32030,65.5,11815,15852,16178,31691,32,52,130,125,284,2598,6684,18006,4742,12391,576,9093,2722,62100,283
MN D,Meeker,Minnesota,27093,-94.50986862,45.11004448,20846,33.41,7651,10270,10576,20583,23,29,92,119,231,1587,4540,11136,3583,9139,1488,6092,1559,49100,234
MN D,Mille Lacs,Minnesota,27095,-93.61957932,45.89943695,18670,32.3,6911,9173,9497,17969,27,620,36,18,87,1425,4012,10037,3196,9065,2154,5507,1404,50800,254
MN D,Morrison,Minnesota,27097,-94.20658493,46.06192589,29604,26.34,10399,14778,14826,29408,33,77,45,41,98,2338,6920,15728,4618,12434,2035,8503,1896,47100,223
MN D,Mower,Minnesota,27099,-92.75358963,43.67335701,37385,52.58,15028,18141,19244,36893,71,51,295,75,248,2441,7114,20303,7527,15831,803,11623,3405,42600,228
MN D,Murray,Minnesota,27101,-95.76861954,44.02219772,9660,13.76,3758,4769,4891,9630,0,3,17,10,21,641,1979,5049,1991,4611,853,2982,776,30400,156
MN D,Nicollet,Minnesota,27103,-94.36049652,44.31051636,28076,63.81,9478,13905,14171,27636,89,57,203,91,203,2026,5321,17630,3099,9963,485,6905,2573,65200,324
MN D,Nobles,Minnesota,27105,-95.75974655,43.67316628,20098,28.15,7683,9851,10247,19407,49,77,406,159,262,1353,3978,11048,3719,8094,411,5791,1892,39600,237
MN D,Norman,Minnesota,27107,-96.46850967,47.32681656,7975,9.09,3118,3958,4017,7866,4,71,16,18,72,483,1670,4041,1781,3648,530,2498,620,30200,161
MN D,Olmsted,Minnesota,27109,-92.38922501,44.01440811,106470,162.55,40058,51685,54785,101880,788,295,3237,270,970,9160,20368,66338,10604,41603,1545,29012,11046,72300,379
MN D,Otter Tail,Minnesota,27111,-95.7142334,46.41055489,50714,25.7,19510,25120,25594,50191,31,232,189,71,224,3457,9986,27426,9845,29295,9785,15235,4275,46600,227
MN D,Pennington,Minnesota,27113,-96.04483795,48.05359077,13306,21.53,5173,6603,6703,13100,11,101,48,46,106,900,2662,7495,2249,5682,509,3828,1345,41400,212
MN D,Pine,Minnesota,27115,-92.71276855,46.07425499,21264,14.96,7577,11101,10163,20374,352,360,82,96,348,1450,4593,11874,3347,12738,5161,6252,1325,44900,227
MN D,Pipestone,Minnesota,27117,-96.26142502,44.02310181,10491,22.51,4078,5017,5474,10245,6,153,78,9,42,795,2154,5349,2193,4387,309,3129,949,31700,180
MN D,Polk,Minnesota,27119,-96.66877202,47.83794403,32498,16.4,11984,16004,16494,31501,73,418,96,410,1146,2353,6790,17570,5785,14275,2291,8950,3034,47200,243
MN D,Pope,Minnesota,27121,-95.44506836,45.58489609,10745,16.09,4135,5279,5466,10698,5,23,12,7,7,743,2217,5400,2385,5836,1701,3254,881,39200,188
MN D,Ramsey,Minnesota,27123,-93.10559082,45.01016617,485765,3154.32,190500,231984,253781,427677,22674,4509,24792,6113,13890,38783,81321,306273,59388,201016,10516,118499,72001,83600,418
MN D,Red Lake,Minnesota,27125,-96.09881973,47.86423874,4525,10.45,1730,2287,2238,4475,0,7,3,40,46,324,1030,2333,838,1899,169,1363,367,28200,160
MN D,Redwood,Minnesota,27127,-95.23023987,44.44947243,17254,19.56,6554,8483,8771,16875,27,280,31,41,91,1279,3567,8851,3557,7144,590,5055,1499,32800,179
MN D,Renville,Minnesota,27129,-94.99060822,44.67333984,17673,17.96,6790,8733,8940,17422,7,58,46,140,216,1284,3638,9161,3590,7442,652,5378,1412,31600,183
MN D,Rice,Minnesota,27131,-93.28673935,44.36978912,49183,98.17,16347,24128,25055,48081,174,113,607,208,530,3401,9507,30477,5798,17520,1173,12338,4009,67800,316
MN D,Rock,Minnesota,27133,-96.25909042,43.67366791,9806,20.3,3754,4758,5048,9731,12,33,19,11,29,673,2113,5073,1947,3963,209,2826,928,36600,178
MN D,Roseau,Minnesota,27135,-95.75086975,48.77150154,15026,8.96,5415,7695,7331,14774,4,146,94,8,26,1443,3240,8313,2030,6236,821,4472,943,49400,256
MN D,Scott,Minnesota,27139,-93.59519958,44.67962074,57846,162.03,19367,29266,28580,56583,267,362,534,100,407,5478,12523,35604,4241,20302,935,15857,3510,90900,431
MN D,Sherburne,Minnesota,27141,-93.83123779,45.40507889,41945,96.43,13643,21448,20497,41182,263,208,204,88,259,3648,9670,25649,2978,14964,1321,10977,2666,74800,406
MN D,Sibley,Minnesota,27143,-94.20119476,44.58926964,14366,24.23,5323,7150,7216,14259,5,16,34,52,127,1067,3015,7747,2537,5625,302,4339,984,44400,191
MN D,St. Louis,Minnesota,27137,-92.44113159,47.64753723,198213,32.36,78901,96435,101778,192053,1106,3682,1076,296,952,12185,36136,116425,33467,95403,16502,58541,20360,42200,256
MN D,Stearns,Minnesota,27145,-94.59407043,45.53099632,118791,88.78,39776,59547,59244,117061,414,306,838,172,512,8983,24026,73306,12476,43806,4030,28418,11358,61400,352
MN D,Steele,Minnesota,27147,-93.23045731,44.02140617,30729,71.3,11342,15033,15696,30258,51,49,153,218,544,2408,6384,17643,4294,11840,498,8746,2596,61200,272
MN D,Stevens,Minnesota,27149,-95.99932098,45.58515358,10634,18.99,3823,5141,5493,10366,58,50,119,41,56,618,1882,6433,1701,4108,285,2569,1254,37700,240
MN D,Swift,Minnesota,27151,-95.68524933,45.28307915,10724,14.43,4268,5273,5451,10623,4,38,38,21,79,676,2206,5465,2377,4795,527,3306,962,27500,178
MN D,Todd,Minnesota,27153,-94.9001503,46.0702076,23363,24.83,8589,11620,11743,23233,8,51,53,18,58,1636,5495,12255,3977,11234,2645,6944,1645,35000,184
MN D,Traverse,Minnesota,27155,-96.55464935,45.8027935,4463,7.76,1778,2166,2297,4321,0,126,16,0,8,306,865,2203,1089,2220,442,1405,373,23400,152
MN D,Wabasha,Minnesota,27157,-92.20102692,44.28143883,19744,36.77,7286,9797,9947,19581,12,47,89,15,79,1541,4171,10890,3142,8205,919,5954,1332,51900,245
MN D,Wadena,Minnesota,27159,-94.94945526,46.5863266,13154,24.45,4978,6415,6739,13016,8,77,36,17,47,959,2753,6915,2527,5801,823,3804,1174,36200,181
MN D,Waseca,Minnesota,27161,-93.59251785,44.02365875,18079,42.84,6649,8930,9149,17884,26,46,76,47,129,1350,3834,10064,2831,7011,362,5138,1511,53500,251
MN D,Washington,Minnesota,27163,-92.88371658,45.02238274,145896,374.09,49246,73186,72710,141266,1601,687,1648,694,1895,12138,32177,92088,9493,51648,2402,41307,7939,94200,450
MN D,Watonwan,Minnesota,27165,-94.61734009,43.97686577,11682,26.86,4530,5734,5948,11120,9,24,57,472,593,875,2406,6268,2133,4886,356,3387,1143,35500,195
MN D,Wilkin,Minnesota,27167,-96.52438354,46.32506752,7516,10.01,2805,3721,3795,7426,2,41,23,24,43,585,1541,4099,1291,3140,335,2178,627,38400,197
MN D,Winona,Minnesota,27169,-91.68862152,44.01968002,47828,75.92,16930,23313,24515,46892,195,113,526,102,350,3191,8539,29537,6561,17630,700,12205,4725,54400,282
MN D,Wright,Minnesota,27171,-93.88975143,45.20443344,68710,102.25,23013,34607,34103,68035,74,233,277,91,284,6209,16176,39612,6713,26353,3340,18866,4147,75000,326
MN D,Yellow Medicine,Minnesota,27173,-95.90934753,44.73944473,11684,15.41,4607,5782,5902,11496,3,115,23,47,82,781,2374,6035,2494,4983,376,3590,1017,31100,174
MO ED,Adair,Missouri,29001,-92.60625839,40.19087791,24577,43.35,9060,11491,13086,24029,219,42,220,67,182,1368,3580,16362,3267,10097,1037,5381,3679,41900,217
MO ED,Audrain,Missouri,29007,-91.86724091,39.20504951,23599,33.86,9205,11367,12232,22037,1419,34,83,26,81,1581,4642,12818,4558,10039,834,6830,2375,36000,178
MO ED,Bollinger,Missouri,29017,-90.04375458,37.32497215,10619,17.1,3946,5264,5355,10545,12,31,28,3,70,744,2038,6030,1807,4542,596,3224,722,29400,159
MO ED,Butler,Missouri,29023,-90.41212845,36.70828819,38765,55.54,15334,18469,20296,36487,1983,134,125,36,217,2533,7430,22375,6427,17046,1712,10442,4892,36300,183
MO ED,Cape Girardeau,Missouri,29031,-89.64849854,37.36571884,61633,106.82,23390,29598,32035,57964,2985,101,475,108,313,4119,10510,38483,8521,25315,1925,15839,7551,56900,251
MO ED,Carter,Missouri,29035,-90.94755173,36.95618057,5515,10.83,2128,2726,2789,5466,1,38,5,5,33,391,1131,3120,873,2693,565,1570,558,29900,147
MO ED,Chariton,Missouri,29041,-92.99242783,39.46287346,9202,12.14,3661,4411,4791,8835,337,17,7,6,19,625,1749,4838,1990,4479,818,2851,810,26100,139
MO ED,Crawford,Missouri,29055,-91.3225708,37.95464134,19173,25.77,7299,9338,9835,19092,3,36,30,12,114,1296,3864,10714,3299,9030,1731,5723,1576,37900,187
MO ED,Dent,Missouri,29065,-91.49214935,37.59997177,13702,18.15,5327,6572,7130,13568,10,67,33,24,89,851,2760,7525,2566,6115,788,3935,1392,34800,163
MO ED,Dunklin,Missouri,29069,-90.00993705,36.30973625,33112,60.53,13128,15353,17759,30280,2629,87,77,39,169,2226,6519,18384,5983,14102,974,8768,4360,30000,137
MO ED,Franklin,Missouri,29071,-91.05770874,38.4531765,80603,87.42,28856,39781,40822,79403,750,155,192,103,441,6308,16692,47828,9775,32451,3595,22508,6348,58300,259
MO ED,Gasconade,Missouri,29073,-91.51159286,38.43514442,14006,26.88,5543,6759,7247,13947,11,22,17,9,35,951,2537,7575,2943,7158,1615,4452,1091,41800,180
MO ED,Iron,Missouri,29093,-90.66644377,37.50566101,10726,19.43,3995,5057,5669,10632,49,14,14,17,44,671,2193,5840,2022,4700,705,3034,961,34900,169
MO ED,Jefferson,Missouri,29099,-90.51836014,38.25169754,171380,259.27,59199,85034,86346,168977,1202,425,543,233,1151,14396,36602,106141,14241,63423,4224,48086,11113,65300,316
MO ED,Knox,Missouri,29103,-92.15207291,40.12739944,4482,8.84,1819,2153,2329,4461,6,10,3,2,9,287,783,2443,969,2254,435,1364,455,20500,142
MO ED,Lewis,Missouri,29111,-91.70383835,40.10220337,10233,20.1,3745,4889,5344,9846,342,19,16,10,26,609,1795,6010,1819,4244,499,2770,975,28000,157
MO ED,Lincoln,Missouri,29113,-90.96895981,39.04904175,28892,46.08,10316,14416,14476,28080,590,102,54,66,219,2444,6232,16899,3317,12284,1968,8257,2059,55200,236
MO ED,Linn,Missouri,29115,-93.11384964,39.86780167,13885,22.4,5704,6475,7410,13714,113,22,14,22,94,871,2584,7178,3252,6566,862,4426,1278,22400,150
MO ED,Macon,Missouri,29121,-92.57361221,39.82461929,15345,19.25,6160,7296,8049,14905,363,50,19,8,59,883,2891,8281,3290,6955,795,4714,1446,32700,168
MO ED,Madison,Missouri,29123,-90.35242462,37.47751617,11127,22.39,4344,5371,5756,11033,10,32,34,18,62,742,2119,6142,2124,5282,938,3333,1011,33100,181
MO ED,Maries,Missouri,29125,-91.91873932,38.15039063,7976,15.11,3028,3945,4031,7909,27,19,10,11,40,543,1527,4557,1349,3715,687,2488,540,35000,160
MO ED,Marion,Missouri,29127,-91.58419037,39.80454063,27682,63.2,10728,13043,14639,26213,1249,75,109,36,118,1955,5583,15180,4964,12026,1298,7415,3313,36000,189
MO ED,Mississippi,Missouri,29133,-89.31628799,36.83025551,14442,35.22,5411,6750,7692,11590,2804,26,15,7,40,1056,3113,7904,2369,5757,346,3512,1899,32300,136
MO ED,Monroe,Missouri,29137,-92.01465988,39.50184822,9104,13.59,3471,4448,4656,8713,357,18,14,2,48,651,1852,4879,1722,4114,643,2689,782,31800,167
MO ED,Montgomery,Missouri,29139,-91.45923233,38.91368866,11355,21.03,4341,5480,5875,11015,289,12,20,19,45,783,2188,6131,2253,5241,900,3426,915,33000,176
MO ED,New Madrid,Missouri,29143,-89.65890884,36.61371422,20928,31.81,7795,9960,10968,17558,3279,34,36,21,93,1501,4620,11672,3135,8557,762,4990,2805,32800,143
MO ED,Pemiscot,Missouri,29155,-89.74142838,36.21369934,21921,42.4,8210,10241,11680,16222,5596,34,51,18,89,1829,4931,11540,3621,8806,596,4673,3537,28800,120
MO ED,Perry,Missouri,29157,-89.8327446,37.73872185,16648,35.2,6111,8246,8402,16525,15,29,69,10,72,1195,3464,9044,2945,6867,756,4957,1154,43500,188
MO ED,Phelps,Missouri,29161,-91.78142166,37.87807846,35248,52.3,13277,18086,17162,33815,397,148,783,105,303,2298,6124,21972,4854,14715,1438,8715,4562,47200,216
MO ED,Pike,Missouri,29163,-91.09899521,39.37159729,15969,23.73,6083,7717,8252,15033,845,52,24,15,119,1134,3222,8855,2758,7128,1045,4542,1541,32600,169
MO ED,Ralls,Missouri,29173,-91.46345901,39.50375175,8476,17.59,3226,4124,4352,8312,138,18,6,2,14,536,1714,4813,1413,3766,540,2591,635,37900,177
MO ED,Randolph,Missouri,29175,-92.50715637,39.42923546,24370,51.09,8943,12291,12079,22332,1837,80,79,42,179,1561,4527,14285,3997,10131,1188,6532,2411,33200,185
MO ED,Reynolds,Missouri,29179,-91.03188324,37.32836723,6661,8.23,2542,3277,3384,6633,3,15,5,5,28,417,1337,3803,1104,3537,995,1945,597,29300,147
MO ED,Ripley,Missouri,29181,-90.8573494,36.654356,12303,19.5,4788,5835,6468,12211,6,49,22,15,78,832,2473,6720,2278,5597,809,3623,1165,29200,143
MO ED,Schuyler,Missouri,29197,-92.53922653,40.4703846,4236,13.71,1729,2028,2208,4217,0,8,4,7,18,302,738,2224,972,1986,257,1304,425,20400,136
MO ED,Scotland,Missouri,29199,-92.15376282,40.45518875,4822,11.01,1956,2317,2505,4808,3,10,0,1,12,352,873,2501,1096,2302,346,1439,517,24300,140
MO ED,Scott,Missouri,29201,-89.54535294,37.05892372,39376,93.09,14761,18617,20759,35660,3497,86,68,65,206,3022,8169,22561,5624,15881,1120,10201,4560,41700,201
MO ED,Shannon,Missouri,29203,-91.3459549,37.15183067,7613,7.58,2917,3714,3899,7573,3,27,4,6,22,557,1474,4351,1231,3312,395,2296,621,25900,125
MO ED,Shelby,Missouri,29205,-92.07434845,39.78003311,6942,13.86,2809,3256,3686,6858,56,18,3,7,23,475,1324,3525,1618,3277,468,2126,683,22900,138
MO ED,St. Charles,Missouri,29183,-90.54088593,38.7514801,212907,381.55,74331,105492,107415,205424,4963,528,1431,561,2308,19023,45044,134148,14692,79113,4782,56785,17546,83600,395
MO ED,St. Clair,Missouri,29185,-93.79030991,38.02223206,8457,12.1,3499,4025,4432,8379,22,41,11,4,33,512,1464,4515,1966,4645,1146,2631,868,28400,141
MO ED,St. Francois,Missouri,29187,-90.54244281,37.86098099,48904,108.43,17670,24397,24507,47642,962,107,123,70,239,3176,9272,28748,7708,20321,2651,13079,4591,40200,224
MO ED,St. Louis,Missouri,29189,-90.43062592,38.64020538,993529,1963.5,380110,473533,519996,836232,139318,1477,14167,2335,9811,69322,175073,619136,129998,401839,21729,280843,99267,83500,397
MO ED,St. Louis City,Missouri,29510,-90.21909714,38.66663933,396685,6503.03,164931,180680,216005,202085,188408,950,3733,1509,5124,31355,68685,230644,66001,194919,29988,74352,90579,50700,252
MO ED,Ste. Genevieve,Missouri,29186,-90.20056152,37.89728165,16037,31.82,5707,7976,8061,15925,45,31,24,12,49,1156,3333,9274,2274,6766,1059,4719,988,53800,192
MO ED,Stoddard,Missouri,29207,-89.98094177,36.87886047,28895,35.45,11383,13798,15097,28347,409,58,47,34,132,1755,5464,16610,5066,12288,905,8182,3201,34100,160
MO ED,Warren,Missouri,29219,-91.19329834,38.7712307,19534,45.53,7070,9680,9854,18903,513,46,33,39,152,1599,3886,11347,2702,8841,1771,5713,1357,63600,259
MO ED,Washington,Missouri,29221,-90.87465668,37.97157097,20380,26.75,6982,10358,10022,19914,378,47,23,18,83,1546,4535,11931,2368,8075,1093,5479,1503,34200,180
MO ED,Wayne,Missouri,29223,-90.45141602,37.11830139,11543,15.15,4607,5639,5904,11471,7,45,9,11,44,696,2037,6522,2288,6406,1799,3526,1081,29000,156
MO WD,Andrew,Missouri,29003,-94.84376907,39.97399139,14632,33.64,5429,7111,7521,14516,30,41,23,22,103,986,2966,8377,2303,5841,412,4269,1160,45900,220
MO WD,Atchison,Missouri,29005,-95.47555161,40.42763138,7457,13.76,2961,3650,3807,7280,83,15,14,65,104,398,1281,4202,1576,3298,337,1950,1011,28800,153
MO WD,Barry,Missouri,29009,-93.83198166,36.70997047,27547,35.64,10858,13486,14061,27133,25,276,80,33,152,1812,5165,15419,5151,12908,2050,8386,2472,42300,195
MO WD,Barton,Missouri,29011,-94.34963226,37.49864578,11312,18.98,4524,5456,5856,11151,11,108,28,14,57,766,2220,6102,2224,5014,490,3340,1184,31800,168
MO WD,Bates,Missouri,29013,-94.33576202,38.24868393,15025,17.7,5918,7245,7780,14817,107,78,10,13,82,981,2947,8135,2962,6782,864,4413,1505,31400,175
MO WD,Benton,Missouri,29015,-93.29330063,38.30016327,13859,19.01,5764,6771,7088,13736,13,75,17,18,78,706,2271,7742,3140,10280,4516,4693,1071,38300,184
MO WD,Boone,Missouri,29019,-92.33536148,38.94434166,112379,163.58,41937,54400,57979,100055,8377,394,3129,424,1226,7923,17441,77572,9443,44695,2758,23078,18859,65700,299
MO WD,Buchanan,Missouri,29021,-94.86159134,39.67512894,83083,203.14,32486,39370,43713,79378,2635,273,266,531,1709,5976,15477,47993,13637,35652,3166,22081,10405,40800,230
MO WD,Caldwell,Missouri,29025,-93.99143982,39.65590477,8380,19.49,3222,3989,4391,8335,14,21,2,8,50,585,1615,4437,1743,3649,427,2456,766,25600,168
MO WD,Callaway,Missouri,29027,-91.93416214,38.81451607,32809,38.97,11552,15923,16886,30937,1579,104,120,69,171,2393,6204,20120,4092,13003,1451,8881,2671,48900,208
MO WD,Camden,Missouri,29029,-92.74423599,38.03282738,27495,42.89,11305,13719,13776,27259,58,107,46,25,170,1583,4411,16437,5064,25662,14357,9122,2183,71700,254
MO WD,Carroll,Missouri,29033,-93.44465256,39.41040611,10748,15.46,4332,5112,5636,10487,220,14,11,16,40,697,2128,5625,2298,5001,669,3178,1154,26900,152
MO WD,Cass,Missouri,29037,-94.34394073,38.63818359,63808,91.02,22892,31102,32706,62218,684,381,269,256,829,5127,13425,38431,6825,24337,1445,17486,5406,64600,306
MO WD,Cedar,Missouri,29039,-93.84927368,37.73475456,12093,25.73,5003,5736,6357,11976,3,77,20,17,58,716,2098,6363,2916,6035,1032,3984,1019,34200,161
MO WD,Christian,Missouri,29043,-93.26246643,36.95490265,32644,57.88,11937,15946,16698,32274,35,190,77,68,216,2430,6899,19672,3643,12812,875,9500,2437,58500,249
MO WD,Clark,Missouri,29045,-91.70152283,40.43056297,7547,14.89,2859,3750,3797,7528,3,7,4,5,26,499,1555,4204,1289,3398,539,2170,689,26300,150
MO WD,Clay,Missouri,29047,-94.41518021,39.28409004,153411,380.67,58915,74164,79247,147721,2693,782,1135,1080,3539,11414,28088,98065,15844,63000,4085,39741,19174,68500,355
MO WD,Clinton,Missouri,29049,-94.41587448,39.59661674,16595,39.23,6112,8026,8569,16122,336,73,22,42,139,1192,3426,9484,2493,6559,447,4743,1369,47900,223
MO WD,Cole,Missouri,29051,-92.22502518,38.53039169,63579,162.19,22976,32412,31167,58115,4829,235,259,141,447,4357,11562,39865,7795,24939,1963,15537,7439,60200,256
MO WD,Cooper,Missouri,29053,-92.78243256,38.87280083,14835,26.16,5359,7653,7182,13557,1147,55,47,29,96,952,2669,8533,2681,6002,643,4017,1342,39600,184
MO WD,Dade,Missouri,29057,-93.85647583,37.43224335,7449,15.17,2976,3547,3902,7336,20,68,15,10,76,518,1365,3912,1654,3543,567,2301,675,30900,151
MO WD,Dallas,Missouri,29059,-93.02313614,37.65464973,12646,23.29,4899,6193,6453,12515,16,89,18,8,65,901,2496,6942,2307,5484,585,3861,1038,33000,165
MO WD,Daviess,Missouri,29061,-93.99692154,39.96020126,7865,13.85,3040,3733,4132,7812,2,30,12,9,46,545,1573,4150,1597,3613,573,2288,752,24600,153
MO WD,De Kalb,Missouri,29063,-94.41453171,39.89209175,9967,23.45,3054,5824,4143,9006,741,81,33,106,200,557,1566,6214,1630,3358,304,2233,821,33200,160
MO WD,Douglas,Missouri,29067,-92.50244522,36.93447495,11876,14.59,4587,5762,6114,11756,3,89,15,13,90,819,2359,6646,2052,5105,518,3559,1028,34000,163
MO WD,Gentry,Missouri,29075,-94.42127991,40.21459961,6848,13.89,2756,3227,3621,6803,6,25,4,10,27,443,1244,3441,1720,3232,476,2054,702,23000,151
MO WD,Greene,Missouri,29077,-93.34963608,37.25754356,207949,307.16,81463,99583,108366,200912,3749,1281,1523,484,1775,13282,34358,132569,27740,87910,6447,51608,29855,58200,281
MO WD,Grundy,Missouri,29079,-93.57095718,40.10946465,10536,24.11,4346,4888,5648,10450,11,43,24,8,77,653,1846,5709,2328,5113,767,3153,1193,24200,162
MO WD,Harrison,Missouri,29081,-94.00482941,40.35577583,8469,11.68,3574,4060,4409,8400,8,31,23,7,37,489,1446,4492,2042,4245,671,2640,934,20200,125
MO WD,Henry,Missouri,29083,-93.79623795,38.38351059,20044,27.5,8189,9596,10448,19655,227,83,49,30,144,1274,3644,11009,4117,9317,1128,6012,2177,36500,179
MO WD,Hickory,Missouri,29085,-93.3247261,37.93455505,7335,19.35,3183,3602,3733,7265,5,55,6,4,29,335,1077,3852,2071,5482,2299,2679,504,37500,156
MO WD,Holt,Missouri,29087,-95.25582504,40.066782,6034,13.2,2440,2943,3091,5994,7,22,5,6,16,396,1147,3115,1376,3190,750,1795,645,22600,138
MO WD,Howard,Missouri,29089,-92.6914444,39.15641022,9631,20.71,3571,4662,4969,8837,732,30,17,15,45,611,1774,5421,1825,4025,454,2680,891,31400,172
MO WD,Howell,Missouri,29091,-91.89723969,36.77459526,31447,33.89,12283,15113,16334,31112,62,167,75,31,161,2128,6134,17706,5479,13326,1043,9059,3224,36800,163
MO WD,Jackson,Missouri,29095,-94.36223984,39.03288841,633232,1036.39,252582,301297,331935,478849,135649,3032,6446,9256,18890,48167,112648,389952,82465,280729,28147,154859,97723,58400,322
MO WD,Jasper,Missouri,29097,-94.33898163,37.20677948,90465,141.13,36134,43088,47377,87093,1153,1504,516,199,797,6157,16965,53245,14098,39554,3420,25035,11099,38300,228
MO WD,Johnson,Missouri,29101,-93.81728745,38.74548912,42514,50.98,14579,21521,20993,38996,2452,206,603,257,709,3232,7144,28193,3945,16010,1431,8549,6030,55300,275
MO WD,Laclede,Missouri,29105,-92.55619049,37.68561363,27158,35.36,10420,13220,13938,26816,96,144,79,23,141,1968,5326,15698,4166,11564,1144,7655,2765,42100,193
MO WD,Lafayette,Missouri,29107,-93.80420685,39.09498024,31107,49.22,11732,15209,15898,29976,880,106,69,76,219,2181,6055,17711,5160,12820,1088,8697,3035,45300,212
MO WD,Lawrence,Missouri,29109,-93.83963776,37.10563087,30236,49.32,11724,14637,15599,29820,24,280,56,56,211,2132,5954,16757,5393,12788,1064,8722,3002,37900,188
MO WD,Livingston,Missouri,29117,-93.51828766,39.78716278,14592,27.17,5645,6687,7905,14193,317,40,27,15,63,946,2740,8067,2839,6294,649,4004,1641,35800,185
MO WD,McDonald,Missouri,29119,-94.34811783,36.62643814,16938,31.37,6386,8403,8535,16313,4,546,41,34,121,1316,3354,9820,2448,7327,941,4826,1560,31800,171
MO WD,Mercer,Missouri,29129,-93.57806778,40.42191696,3723,8.2,1577,1811,1912,3713,3,6,1,0,7,182,657,1928,956,2225,648,1182,395,18900,130
MO WD,Miller,Missouri,29131,-92.44149017,38.22338676,20700,34.91,7977,10086,10614,20547,23,89,23,18,101,1535,4249,11712,3204,9766,1789,6075,1902,43700,195
MO WD,Moniteau,Missouri,29135,-92.61823273,38.67189407,12298,29.49,4583,6053,6245,12044,157,54,36,7,46,854,2536,6819,2089,5043,460,3611,972,38700,178
MO WD,Morgan,Missouri,29141,-92.85366821,38.44021606,15574,26.22,6269,7623,7951,15364,94,70,26,20,69,1022,2582,8757,3213,12642,6373,5059,1210,45300,184
MO WD,Newton,Missouri,29145,-94.34327698,36.90466881,44445,70.89,16886,21644,22801,43000,174,948,235,88,353,3211,8562,26219,6453,18384,1498,12982,3904,42900,210
MO WD,Nodaway,Missouri,29147,-94.91265488,40.35579491,21709,24.81,7620,10484,11225,21278,166,43,165,57,135,1244,3634,13548,3283,8349,729,4986,2634,37100,214
MO WD,Oregon,Missouri,29149,-91.40389633,36.68701172,9470,11.96,3851,4561,4909,9402,3,41,14,10,32,532,1725,5326,1887,4484,633,3042,809,26000,132
MO WD,Osage,Missouri,29151,-91.92375946,38.49727058,12018,19.83,4262,6194,5824,11940,38,21,2,17,56,849,2490,6861,1818,5414,1152,3534,728,43700,163
MO WD,Ozark,Missouri,29153,-92.44709015,36.64808464,8598,11.76,3486,4253,4345,8528,2,39,12,17,56,431,1555,4799,1813,4451,965,2859,627,36500,149
MO WD,Pettis,Missouri,29159,-93.28564072,38.72480583,35437,51.66,14056,17057,18380,33963,1167,103,123,81,268,2536,6679,20444,5778,15443,1387,10465,3591,40100,223
MO WD,Platte,Missouri,29165,-94.85612488,39.34294128,57867,137.45,22142,28702,29165,55127,1217,307,799,417,1161,4245,10958,37872,4792,24362,2220,14408,7734,81200,371
MO WD,Polk,Missouri,29167,-93.40737152,37.61977005,21826,34.32,8031,10658,11168,21508,70,134,76,38,173,1416,3943,12782,3685,8979,948,5905,2126,39600,185
MO WD,Pulaski,Missouri,29169,-92.21623993,37.81241989,41307,75.1,12397,22871,18436,33139,5608,261,1209,1090,1953,3650,8272,26593,2792,13838,1441,6888,5509,51400,278
MO WD,Putnam,Missouri,29171,-93.02213287,40.46480179,5079,9.77,2166,2449,2630,5059,1,9,4,6,24,281,870,2711,1217,2590,424,1667,499,21300,134
MO WD,Ray,Missouri,29177,-93.99239349,39.33194923,21971,38.68,8020,10766,11205,21477,302,112,35,45,119,1616,4648,12769,2938,8611,591,6337,1683,46400,224
MO WD,Saline,Missouri,29195,-93.18105316,39.1685257,23523,31.16,8903,11334,12189,21974,1352,45,61,91,208,1463,4439,13319,4302,10033,1130,6284,2619,37600,197
MO WD,Stone,Missouri,29209,-93.46944809,36.74075317,19078,42.3,7885,9285,9793,18883,6,138,37,14,114,1018,3082,10969,4009,11294,3409,6434,1451,58800,217
MO WD,Sullivan,Missouri,29211,-93.11391068,40.21033859,6326,9.72,2615,3032,3294,6304,1,14,2,5,28,334,1047,3371,1574,3093,478,1976,639,16100,144
MO WD,Taney,Missouri,29213,-93.05005646,36.65299797,25561,42.04,10321,12326,13235,25251,16,152,83,59,194,1351,3936,14837,5437,13273,2952,7713,2608,55400,225
MO WD,Texas,Missouri,29215,-91.95725632,37.32799911,21476,18.2,8441,10360,11116,21294,16,84,60,22,113,1452,4337,12052,3635,9525,1084,6360,2081,33700,149
MO WD,Vernon,Missouri,29217,-94.34181976,37.85008812,19041,22.75,7301,8952,10089,18787,59,113,65,17,102,1285,3681,10812,3263,8181,880,5291,2010,32100,179
MO WD,Webster,Missouri,29225,-92.88248825,37.27901268,23753,39.99,8391,11963,11790,23322,190,148,45,48,140,1798,5007,13873,3075,9067,676,6526,1865,41200,190
MO WD,Worth,Missouri,29227,-94.43013763,40.48124504,2440,9.17,1037,1161,1279,2425,1,1,5,8,9,161,425,1229,625,1269,232,787,250,14999,118
MO WD,Wright,Missouri,29229,-92.47312927,37.27280998,16758,24.57,6510,8101,8657,16575,36,119,12,16,61,1200,3508,9187,2863,7214,704,4801,1709,31100,156
MS ND,Alcorn,Mississippi,28003,-88.58208847,34.88230896,31722,79.11,12449,15192,16530,28085,3540,22,53,22,127,1983,6106,18749,4884,13704,1255,9420,3029,38800,157
MS ND,Attala,Mississippi,28007,-89.63908386,33.08985519,18481,25.08,6945,8662,9819,11114,7299,32,28,8,58,1273,3773,10038,3397,7674,729,5432,1513,36500,128
MS ND,Benton,Mississippi,28009,-89.17436981,34.79675865,8046,19.77,2842,3882,4164,4869,3168,5,4,0,37,595,1803,4460,1188,3379,537,2444,398,35100,122
MS ND,Bolivar,Mississippi,28011,-90.94241333,33.83188629,41875,46.95,13292,19280,22595,15259,26326,26,138,126,377,3644,10523,22504,5204,14514,1222,7895,5397,39200,160
MS ND,Calhoun,Mississippi,28013,-89.31900024,33.94541359,14908,26.02,5662,7119,7789,10829,4027,12,4,36,78,1021,2901,8462,2524,6260,598,4576,1086,33900,145
MS ND,Carroll,Mississippi,28015,-89.90634155,33.45252037,9237,14.57,3352,4429,4808,5560,3654,11,10,2,42,655,1996,5184,1402,3948,596,2699,653,34400,124
MS ND,Chickasaw,Mississippi,28017,-88.94608307,33.91215706,18085,35.95,6480,8633,9452,11060,6981,21,19,4,85,1470,3935,10186,2494,6997,517,5086,1394,37800,144
MS ND,Choctaw,Mississippi,28019,-89.26602173,33.32727432,9071,21.6,3217,4301,4770,6319,2731,9,10,2,31,631,2109,5000,1331,3539,322,2754,463,36000,133
MS ND,Clay,Mississippi,28025,-88.74798584,33.66145325,21120,50.89,7251,9981,11139,9789,11266,19,32,14,80,1641,4892,11774,2813,7737,486,5396,1855,41500,171
MS ND,Coahoma,Mississippi,28027,-90.6745491,34.2592659,31665,56.65,10530,14412,17253,11001,20454,20,112,78,271,2838,7976,16355,4496,11495,965,5966,4564,36700,145
MS ND,De Soto,Mississippi,28033,-90.01126862,34.85593796,67910,140.6,23273,33436,34474,58860,8675,119,157,99,306,5358,14254,42684,5614,24472,1199,18931,4342,62400,311
MS ND,Grenada,Mississippi,28043,-89.81807327,33.78726959,21555,51.2,7701,10054,11501,12563,8916,31,31,14,86,1694,4591,12215,3055,8712,1011,5397,2304,44300,174
MS ND,Humphreys,Mississippi,28053,-90.52692032,33.12901497,12134,28.22,3926,5655,6479,3856,8222,9,43,4,69,1097,3249,6237,1551,4231,305,2304,1622,36600,126
MS ND,Itawamba,Mississippi,28057,-88.34567261,34.27981949,20017,37.07,7497,9785,10232,18596,1359,19,33,10,99,1221,3642,12067,3087,8116,619,6392,1105,35500,151
MS ND,Lafayette,Mississippi,28071,-89.47802353,34.36590004,31826,47.57,11090,15493,16333,23151,7980,28,645,22,203,1724,4885,22005,3212,12478,1388,6843,4247,51100,272
MS ND,Lee,Mississippi,28081,-88.67570496,34.30070877,65581,145.41,24450,31269,34312,51260,14049,59,137,76,360,5234,13262,39446,7639,25971,1521,16882,7568,54000,242
MS ND,Leflore,Mississippi,28083,-90.27192307,33.53004265,37341,61.72,12749,17291,20050,14516,22642,23,130,30,146,3088,8924,20114,5215,13799,1050,6674,6075,42700,141
MS ND,Lowndes,Mississippi,28087,-88.45846939,33.5178566,59308,114.72,21402,28278,31030,36736,22041,76,302,153,491,5053,12545,35688,6022,23117,1715,13616,7786,49500,236
MS ND,Marshall,Mississippi,28093,-89.48017502,34.75120163,30361,42.82,10077,14513,15848,14842,15378,64,37,40,133,2446,6648,17778,3489,10984,907,8011,2066,41900,145
MS ND,Monroe,Mississippi,28095,-88.45700455,33.87366295,36582,47.39,13348,17239,19343,25394,11097,26,28,37,186,2686,7804,20840,5252,14285,937,10412,2936,39200,156
MS ND,Montgomery,Mississippi,28097,-89.58320618,33.48586655,12388,30.36,4532,5771,6617,6916,5440,11,16,5,50,853,2681,6778,2076,4987,455,3362,1170,35400,131
MS ND,Oktibbeha,Mississippi,28105,-88.87349701,33.43218803,38375,83.61,12916,19138,19237,24064,13171,29,1020,91,330,2403,6259,26297,3416,13861,945,7615,5301,51200,255
MS ND,Panola,Mississippi,28107,-89.95759201,34.3633976,29996,43.22,10130,14209,15787,15376,14533,32,34,21,153,2465,7097,16468,3966,11482,1352,7712,2418,39300,147
MS ND,Pontotoc,Mississippi,28115,-89.02996445,34.2313652,22237,44.56,8346,10760,11477,18917,3246,32,32,10,65,1607,4421,13043,3166,9001,655,6716,1630,41200,173
MS ND,Prentiss,Mississippi,28117,-88.52182007,34.6148777,23278,55.69,8647,11179,12099,20477,2741,24,24,12,94,1628,4380,13959,3311,9155,508,6823,1824,36700,155
MS ND,Quitman,Mississippi,28119,-90.29054642,34.2988472,10490,25.84,3521,4879,5611,4250,6193,16,18,13,48,900,2571,5369,1650,3880,359,2407,1114,27900,100
MS ND,Sunflower,Mississippi,28133,-90.60682678,33.63328171,32867,46.55,9650,16479,16388,11604,21092,28,97,46,184,2569,7876,18300,4122,10167,517,5798,3852,37800,146
MS ND,Tallahatchie,Mississippi,28135,-90.1889534,33.93221664,15210,23.36,5034,7163,8047,6257,8881,14,51,7,82,1317,3726,7982,2185,5492,458,3500,1534,31500,99
MS ND,Tate,Mississippi,28137,-89.95311356,34.67167854,21432,52.79,7024,10320,11112,13945,7417,37,27,6,121,1619,4663,12557,2593,7474,450,5310,1714,49500,185
MS ND,Tippah,Mississippi,28139,-88.89388275,34.80361366,19523,42.63,7158,9364,10159,16251,3233,17,18,4,64,1356,3918,11241,3008,7846,688,5687,1471,35200,140
MS ND,Tishomingo,Mississippi,28141,-88.22229385,34.73477173,17683,40.74,7059,8432,9251,17010,631,24,13,5,56,1118,3053,10530,2982,8455,1396,5603,1456,38700,134
MS ND,Tunica,Mississippi,28143,-90.39285278,34.6558857,8164,17.75,2526,3810,4354,1992,6148,5,6,13,81,793,2294,4091,986,2990,464,1359,1167,35400,99
MS ND,Union,Mississippi,28145,-88.98218918,34.48908234,22085,53.09,8367,10654,11431,18804,3213,18,25,25,103,1478,4356,12846,3405,9104,737,6547,1820,39700,160
MS ND,Washington,Mississippi,28151,-90.95407867,33.27858162,67935,92.68,22593,31752,36183,28334,39197,63,255,86,416,5894,17133,36747,8161,24567,1974,13464,9129,41700,196
MS ND,Webster,Mississippi,28155,-89.25648117,33.60338593,10222,24.11,3826,4901,5321,7953,2254,3,10,2,57,665,2083,5678,1796,4326,500,3004,822,36000,130
MS ND,Winston,Mississippi,28159,-89.06168747,33.1052742,19433,31.86,7061,9158,10275,11151,8094,168,16,4,70,1372,4342,10739,2980,7613,552,5760,1301,39100,155
MS ND,Yalobusha,Mississippi,28161,-89.71799469,34.03285027,12033,25.17,4614,5619,6414,7479,4526,10,14,4,53,838,2524,6552,2119,5414,800,3655,959,35500,120
MS SD,Adams,Mississippi,28001,-91.39891052,31.48606682,35356,77.54,13262,16270,19086,18028,17212,40,63,13,152,2655,7587,20023,5091,14715,1453,9476,3786,43900,174
MS SD,Amite,Mississippi,28005,-90.82352448,31.17978287,13328,18.21,4830,6443,6885,7272,6038,11,6,1,33,959,2951,7355,2063,5695,865,4152,678,36800,125
MS SD,Claiborne,Mississippi,28021,-90.97841644,32.0099926,11370,23.02,3342,5264,6106,1994,9340,20,16,0,56,799,2385,6861,1325,4099,757,2481,861,39000,123
MS SD,Clarke,Mississippi,28023,-88.67711639,32.02998829,17313,25.02,6334,8206,9107,11312,5977,6,8,10,64,1198,3818,9722,2575,7065,731,5297,1037,36000,142
MS SD,Copiah,Mississippi,28029,-90.42155075,31.87202358,27592,35.42,9304,13168,14424,13602,13920,21,27,22,108,2123,6134,15623,3712,10260,956,7413,1891,35600,141
MS SD,Covington,Mississippi,28031,-89.57376862,31.61804676,16527,39.73,5786,7979,8548,10699,5795,9,19,5,49,1302,3803,9294,2128,6535,749,4942,844,37300,138
MS SD,Forrest,Mississippi,28035,-89.28933334,31.17704296,68314,145.66,25150,31850,36464,46672,21001,91,459,91,499,4996,12729,42325,8264,27740,2590,15324,9826,45200,244
MS SD,Franklin,Mississippi,28037,-90.89437866,31.47293472,8377,14.8,3086,3991,4386,5290,3079,1,4,3,21,627,1852,4545,1353,3555,469,2623,463,35900,102
MS SD,George,Mississippi,28039,-88.64442825,30.86879253,16673,34.52,5779,8202,8471,15025,1587,38,18,5,48,1262,3787,9754,1870,6663,884,4983,796,37500,178
MS SD,Greene,Mississippi,28041,-88.63192368,31.21829224,10220,14.23,3327,5264,4956,7999,2194,11,6,10,65,729,2343,5959,1189,3864,537,2873,454,33800,142
MS SD,Hancock,Mississippi,28045,-89.50094223,30.42449665,31760,66.44,11817,15826,15934,28625,2774,129,164,68,549,2298,6385,18558,4519,16561,4744,9339,2478,52800,254
MS SD,Harrison,Mississippi,28047,-89.10368347,30.49891758,165365,284.62,59557,82407,82958,127630,32281,466,4331,657,2939,13266,32222,101990,17887,67813,8256,36572,22985,55100,280
MS SD,Hinds,Mississippi,28049,-90.39608002,32.31183624,254441,290.79,91023,119089,135352,123177,129558,232,1251,223,1148,19482,51496,154976,28487,99860,8837,56052,34971,57500,292
MS SD,Holmes,Mississippi,28051,-90.08675385,33.13421249,21604,28.46,7139,9987,11617,5176,16375,14,32,7,62,1927,5644,10948,3085,7972,833,5044,2095,30200,99
MS SD,Issaquena,Mississippi,28055,-91.01597988,32.72980118,1909,4.7,633,927,982,833,1072,1,3,0,6,169,452,1041,247,698,65,427,206,35600,99
MS SD,Jackson,Mississippi,28059,-88.63648605,30.5325985,115243,157.65,40454,56596,58647,90114,23581,254,1115,179,1060,8725,25490,70220,10808,45542,5088,29738,10716,50900,272
MS SD,Jasper,Mississippi,28061,-89.11166,32.0190897,17114,25.24,5956,8168,8946,8410,8687,8,7,2,41,1200,4038,9351,2525,6700,744,5259,697,36000,121
MS SD,Jefferson,Mississippi,28063,-91.05108643,31.7468853,8653,16.54,2814,4079,4574,1185,7462,2,4,0,43,762,2303,4564,1024,3167,353,2186,628,34500,99
MS SD,Jefferson Davis,Mississippi,28065,-89.77785492,31.58531952,14051,34.35,4787,6645,7406,6330,7675,22,22,2,44,1023,3337,7665,2026,5336,549,4051,736,36700,136
MS SD,Jones,Mississippi,28067,-89.16425705,31.6314621,62031,89.13,22506,29566,32465,46193,15489,213,102,34,205,4275,12687,36226,8843,25044,2538,17190,5316,41500,177
MS SD,Kemper,Mississippi,28069,-88.62991333,32.75536156,10356,13.52,3626,4969,5387,4407,5739,200,8,2,32,755,2318,5647,1636,4151,525,2916,710,36600,99
MS SD,Lamar,Mississippi,28073,-89.49919128,31.21363831,30424,60.97,10883,14805,15619,26599,3637,38,113,37,168,2407,6699,18460,2858,11849,966,8192,2691,55400,254
MS SD,Lauderdale,Mississippi,28075,-88.65517044,32.40397263,75555,107.17,28232,35793,39762,48706,26280,96,352,121,501,5692,15490,44174,10199,31232,3000,18753,9479,47300,222
MS SD,Lawrence,Mississippi,28077,-90.10100174,31.55022717,12458,28.64,4506,5974,6484,8300,4132,7,15,4,51,874,2884,7017,1683,5160,654,3891,615,40200,141
MS SD,Leake,Mississippi,28079,-89.52267838,32.75561905,18436,31.57,6788,8817,9619,11086,6558,777,8,7,49,1295,3964,10204,2973,7614,826,5753,1035,34700,130
MS SD,Lincoln,Mississippi,28085,-90.49043274,31.53986931,30278,51.58,11089,14397,15881,21162,9038,19,49,10,60,1949,6643,17219,4467,12133,1044,8715,2374,43800,175
MS SD,Madison,Mississippi,28089,-90.08478165,32.64611244,53794,74.92,19276,25519,28275,29789,23731,42,189,43,276,4707,11212,32754,5121,20761,1485,12348,6928,66300,355
MS SD,Marion,Mississippi,28091,-89.84540558,31.22323227,25544,46.61,9110,12313,13231,17733,7721,23,46,21,137,1811,5975,14090,3668,10132,1022,7246,1864,38800,163
MS SD,Neshoba,Mississippi,28099,-89.11455536,32.7574749,24800,43.36,8848,11876,12924,16945,4611,3194,37,13,104,1821,5584,13860,3535,9770,922,7083,1765,38000,130
MS SD,Newton,Mississippi,28101,-89.11706543,32.40515327,20291,34.98,7358,9721,10570,13697,5831,737,7,19,85,1418,4164,11534,3175,8095,737,5998,1360,37600,133
MS SD,Noxubee,Mississippi,28103,-88.55734253,33.10785294,12604,18.06,4140,5925,6679,3959,8588,44,10,3,27,1164,3100,6658,1682,4645,505,3236,904,31700,99
MS SD,Pearl River,Mississippi,28109,-89.58794403,30.74368858,38714,47.33,13760,18744,19970,32888,5545,142,80,59,300,2851,8353,23014,4496,15793,2033,10888,2872,45100,204
MS SD,Perry,Mississippi,28111,-88.98192596,31.17547131,10865,16.69,3802,5256,5609,8333,2447,72,5,8,46,841,2564,6229,1231,4292,490,3137,665,34300,136
MS SD,Pike,Mississippi,28113,-90.40057755,31.18072414,36882,89.96,13408,17225,19657,19931,16843,26,52,30,173,2587,8511,20412,5372,14995,1587,10031,3377,41000,166
MS SD,Rankin,Mississippi,28121,-89.98534775,32.32613754,87161,111.46,29858,42424,44737,72033,14610,72,314,132,520,6017,18085,55119,7940,31872,2014,23697,6161,64400,314
MS SD,Scott,Mississippi,28123,-89.55198288,32.43307877,24137,39.57,8511,11586,12551,14829,9171,59,24,54,141,1974,5311,13621,3231,9488,977,6866,1645,34900,168
MS SD,Sharkey,Mississippi,28125,-90.8067131,32.88843346,7066,16.24,2084,3262,3804,2339,4686,7,24,10,48,608,1990,3614,854,2290,206,1276,808,40800,102
MS SD,Simpson,Mississippi,28127,-89.94418335,31.90746403,23953,40.53,8357,11686,12267,16124,7737,47,26,19,67,1792,5293,13787,3081,9374,1017,6770,1587,38900,170
MS SD,Smith,Mississippi,28129,-89.52464294,32.00747871,14798,23.3,5276,7241,7557,11516,3244,21,7,10,81,1069,3134,8467,2128,5850,574,4524,752,36900,135
MS SD,Stone,Mississippi,28131,-89.10228729,30.7834549,10750,24.1,3685,5296,5454,8362,2344,20,14,10,54,814,2248,6375,1313,4148,463,2941,744,39100,176
MS SD,Walthall,Mississippi,28147,-90.0463829,31.18314934,14352,35.52,4929,6936,7416,8252,6054,15,27,4,50,1078,3457,7730,2087,5643,714,4156,773,39100,150
MS SD,Warren,Mississippi,28149,-90.85959625,32.34010887,47880,80.34,17407,22612,25268,28879,18666,52,237,46,254,3439,10858,27344,6239,19512,2105,11986,5421,50600,211
MS SD,Wayne,Mississippi,28153,-88.69025421,31.66208649,19517,24.01,6858,9344,10173,12506,6957,19,32,3,75,1495,4602,11130,2290,7723,865,5743,1115,37100,132
MS SD,Wilkinson,Mississippi,28157,-91.34454346,31.18855667,9678,14.27,3347,4540,5138,3123,6532,15,2,6,45,787,2160,5288,1443,4242,895,2724,623,35700,99
MS SD D,Yazoo,Mississippi,28163,-90.3576889,32.76944733,25506,27.34,8813,11937,13569,11958,13443,30,52,23,103,2116,6159,13461,3770,9549,736,5843,2970,38400,125
MT D,Beaverhead,Montana,30001,-112.6916313,45.14587975,8424,1.52,3211,4260,4164,8194,8,121,29,72,133,614,1727,4996,1087,4128,917,1975,1236,55500,195
MT D,Big Horn,Montana,30003,-107.4814911,45.51812553,11337,2.28,3448,5588,5749,4916,18,6289,46,68,294,1216,2940,6164,1017,4304,856,2160,1288,41600,178
MT D,Blaine,Montana,30005,-108.9035301,48.36480713,6728,1.58,2379,3358,3370,4040,6,2664,6,12,54,638,1596,3605,889,2930,551,1479,900,40800,159
MT D,Broadwater,Montana,30007,-111.4242706,46.31190681,3318,2.79,1280,1689,1629,3254,1,45,5,13,33,223,732,1820,543,1593,313,959,321,46800,216
MT D,Carbon,Montana,30009,-108.9592972,45.3159256,8080,3.93,3269,3897,4183,7977,3,42,17,41,90,472,1705,4313,1590,4828,1559,2390,879,45700,211
MT D,Carter,Montana,30011,-104.5419197,45.56760597,1503,0.45,589,770,733,1487,0,9,2,5,12,105,281,835,282,816,227,456,133,22500,144
MT D,Cascade,Montana,30013,-111.3449783,47.25935555,77691,28.79,30133,38295,39396,72345,1061,3072,792,421,1398,6368,15188,46297,9838,33063,2930,19187,10946,60100,275
MT D,Chouteau,Montana,30015,-110.4798393,47.86167526,5452,1.37,2064,2782,2670,5221,4,212,10,5,25,386,1153,2962,951,2668,604,1431,633,41900,189
MT D,Custer,Montana,30017,-105.4675484,46.32604408,11697,3.1,4631,5720,5977,11398,12,196,27,64,160,759,2454,6496,1988,5405,774,3100,1531,37400,225
MT D,Daniels,Montana,30019,-105.5688973,48.7835598,2266,1.59,919,1115,1151,2242,0,6,18,0,12,103,475,1186,502,1220,301,730,189,30800,173
MT D,Dawson,Montana,30021,-104.864048,47.32257271,9505,4,3691,4712,4793,9376,0,83,28,18,64,636,1992,5444,1433,4487,796,2685,1006,37100,205
MT D,Deer Lodge,Montana,30023,-113.0256233,46.00494194,10278,13.89,4060,5076,5202,9905,29,260,22,62,157,574,1817,5847,2040,4830,770,2961,1099,34000,148
MT D,Fallon,Montana,30025,-104.4790688,46.28556442,3103,1.91,1166,1542,1561,3078,0,9,13,3,6,236,713,1692,462,1525,359,898,268,36700,174
MT D,Fergus,Montana,30027,-109.263176,47.25330162,12083,2.78,4603,5921,6162,11922,10,121,13,17,72,783,2439,6455,2406,5732,1129,3290,1313,40800,199
MT D,Flathead,Montana,30029,-113.9520798,48.29822159,59218,11.58,22834,29316,29902,57897,56,880,240,145,616,4211,12538,34753,7716,26979,4145,16131,6703,64200,272
MT D,Gallatin,Montana,30031,-111.289753,45.33786392,50463,20.1,19015,25782,24681,49180,80,608,449,146,593,3511,8757,33706,4489,21350,2335,11125,7890,70200,292
MT D,Garfield,Montana,30033,-107.0302925,47.41401863,1589,0.35,577,816,773,1583,0,4,2,0,0,108,373,841,267,924,347,409,168,32000,173
MT D,Glacier,Montana,30035,-113.1244087,48.65013504,12121,4.05,3816,5985,6136,5258,11,6823,10,19,78,1337,3159,6465,1160,4797,981,2325,1491,43800,147
MT D,Golden Valley,Montana,30037,-109.2184219,46.39911842,912,0.78,330,467,445,895,0,10,4,3,8,64,189,493,166,432,102,261,69,30800,168
MT D,Granite,Montana,30039,-113.4476585,46.38182449,2548,1.47,1051,1325,1223,2521,0,21,4,2,9,169,509,1400,470,1924,873,792,259,37700,177
MT D,Hill,Montana,30041,-110.1103783,48.56617737,17654,6.09,6426,8788,8866,14729,19,2769,92,45,176,1499,3912,10107,2136,7345,919,4056,2370,53200,228
MT D,Jefferson,Montana,30043,-112.1249619,46.15289116,7939,4.79,2867,4029,3910,7780,5,118,15,21,83,567,1771,4768,833,3302,435,2313,554,63700,215
MT D,Judith Basin,Montana,30045,-110.2732582,47.05044937,2282,1.22,908,1167,1115,2269,0,7,6,0,8,140,441,1295,406,1346,438,662,246,30600,153
MT D,Lake,Montana,30047,-114.1049957,47.58901978,21041,14.56,7814,10501,10540,16411,15,4498,32,85,402,1675,4674,11385,3307,10972,3158,5485,2329,61300,207
MT D,Lewis and Clark,Montana,30049,-112.3334427,47.18246841,47495,13.72,18649,23179,24316,45991,69,1059,242,134,576,3484,9660,28839,5512,21412,2763,12769,5880,61800,279
MT D,Liberty,Montana,30051,-111.085743,48.56362152,2295,1.61,788,1120,1175,2278,3,11,3,0,4,189,543,1206,357,1007,219,565,223,41300,202
MT D,Lincoln,Montana,30053,-115.3384018,48.44532013,17481,4.83,6668,8777,8704,17103,11,282,54,31,197,1250,3979,10110,2142,8002,1334,4888,1780,48900,205
MT D,Madison,Montana,30057,-112.022274,45.27666855,5989,1.67,2387,3087,2902,5908,0,43,14,24,88,359,1170,3452,1008,3902,1515,1643,744,56800,224
MT D,McCone,Montana,30055,-105.8189163,47.59438705,2276,0.87,844,1164,1112,2256,1,17,2,0,10,148,509,1244,375,1161,317,660,184,32300,181
MT D,Meagher,Montana,30059,-110.9728661,46.6319561,1819,0.76,709,942,877,1785,0,18,2,14,26,119,365,1020,315,1259,550,478,231,36500,192
MT D,Mineral,Montana,30061,-115.0839768,47.09494591,3315,2.73,1282,1669,1646,3204,3,79,22,7,41,225,756,1914,420,1635,353,934,348,43700,187
MT D,Missoula,Montana,30063,-114.0521393,47.11198997,78687,30.48,30782,38698,39989,75650,185,1818,836,198,962,5719,14514,50351,8103,33466,2684,18514,12268,66200,273
MT D,Musselshell,Montana,30065,-108.398201,46.44322205,4106,2.19,1661,2048,2058,4056,2,26,8,14,36,199,844,2242,821,2183,522,1297,364,29600,175
MT D,Park,Montana,30067,-110.4227676,45.59370995,14562,5.46,5619,7100,7462,14227,69,113,69,84,232,1023,2660,8586,2293,6926,1307,3724,1895,48100,224
MT D,Petroleum,Montana,30069,-108.2839317,47.17557716,519,0.31,209,276,243,516,0,3,0,0,0,43,98,307,71,293,84,159,50,15500,175
MT D,Phillips,Montana,30071,-108.0416145,48.228405,5163,1.01,1931,2537,2626,4741,2,390,14,16,44,385,1176,2805,797,2765,834,1347,584,41500,195
MT D,Pondera,Montana,30073,-112.3938255,48.228508,6433,3.94,2246,3198,3235,5691,5,704,20,13,31,525,1448,3417,1043,2618,372,1562,684,42100,194
MT D,Powder River,Montana,30075,-105.6280212,45.39526367,2090,0.64,805,1061,1029,2044,0,37,3,6,20,156,420,1186,328,1096,291,591,214,43800,217
MT D,Powell,Montana,30077,-112.8837051,46.93092346,6620,2.84,2234,3858,2762,6271,22,253,25,49,77,399,1087,4201,933,2835,601,1603,631,41900,188
MT D,Prairie,Montana,30079,-105.3449173,46.86435699,1383,0.8,568,715,668,1361,0,15,4,3,16,69,258,706,350,749,181,448,120,19100,158
MT D,Ravalli,Montana,30081,-114.0435181,46.0559063,25010,10.49,9698,12330,12680,24528,36,287,72,87,369,1642,5209,14009,4150,11099,1401,7281,2417,61500,232
MT D,Richland,Montana,30083,-104.6445389,47.74957848,10716,5.15,3956,5320,5396,10445,4,140,25,102,240,871,2515,5901,1429,4825,869,2797,1159,44200,210
MT D,Roosevelt,Montana,30085,-104.9477081,48.28520393,10999,4.67,3694,5374,5625,5569,17,5355,40,18,103,1192,2684,5918,1205,4265,571,2361,1333,40400,173
MT D,Rosebud,Montana,30087,-106.5691672,46.02161026,10505,2.09,3479,5386,5119,7544,33,2807,52,69,225,973,2862,5931,739,4251,772,2395,1084,51800,206
MT D,Sanders,Montana,30089,-115.1217117,47.68455315,8669,3.15,3397,4377,4292,8135,12,471,37,14,104,602,1882,4787,1398,4335,938,2551,846,42000,173
MT D,Sheridan,Montana,30091,-104.5570602,48.69549751,4732,2.81,1899,2332,2400,4650,0,50,12,20,38,279,969,2461,1023,2417,518,1463,436,39500,193
MT D,Silver Bow,Montana,30093,-112.6252213,45.89982033,33941,47.27,13899,16653,17288,33026,33,520,138,224,810,2300,6138,19713,5790,15474,1575,9844,4055,44300,189
MT D,Stillwater,Montana,30095,-109.4522858,45.65199661,6536,3.65,2523,3261,3275,6434,5,52,10,35,92,476,1347,3623,1090,3291,768,1857,666,56200,235
MT D,Sweet Grass,Montana,30097,-109.8614426,45.69431496,3154,1.66,1281,1542,1612,3126,2,16,5,5,7,208,630,1649,667,1639,358,924,357,48000,195
MT D,Teton,Montana,30099,-112.2104721,47.81477737,6271,2.76,2329,3113,3158,6154,3,93,9,12,37,412,1412,3329,1118,2725,396,1710,619,44900,202
MT D,Toole,Montana,30101,-111.7390137,48.60647583,5046,2.61,1922,2486,2560,4900,5,118,16,7,36,367,1110,2750,819,2354,432,1381,541,39100,189
MT D,Treasure,Montana,30103,-107.3381424,46.17930603,874,0.9,339,435,439,854,0,9,2,9,26,57,188,492,137,448,109,219,120,35200,179
MT D,Valley,Montana,30105,-106.6192322,48.33262825,8239,1.67,3268,4110,4129,7423,9,770,19,18,62,546,1703,4603,1387,5304,2036,2332,936,36800,206
MT D,Wheatland,Montana,30107,-109.8433151,46.48561287,2246,1.58,849,1133,1113,2203,1,19,8,15,22,150,459,1175,462,1129,280,639,210,27600,140
MT D,Wibaux,Montana,30109,-104.3267441,47.0205555,1191,1.34,454,602,589,1187,0,2,2,0,2,73,257,624,237,563,109,329,125,28900,175
MT D,Yellowstone,Montana,30111,-108.1951637,45.9787178,113419,43.22,44689,54960,58459,107921,511,3235,612,1140,3158,8418,22455,68547,13999,48781,4092,29371,15318,62800,289
MT D,Yellowstone National Park (Part),Montana,30113,-111.0734864,44.79172325,52,0.21,24,25,27,52,0,0,0,0,0,5,5,41,1,46,22,3,21,0,207
NC ED,Beaufort,North Carolina,37013,-76.84402847,35.47697258,42283,51.19,16157,19953,22330,28949,13194,28,48,64,197,2766,8189,25008,6320,19598,3441,11973,4184,52600,191
NC ED,Bertie,North Carolina,37015,-77.01298523,36.02758217,20388,29.08,7412,9408,10980,7790,12531,46,14,7,32,1507,4334,11562,2985,8331,919,5503,1909,39100,135
NC ED,Bladen,North Carolina,37017,-78.53297043,34.6097641,28663,32.61,10760,13481,15182,16926,11199,464,30,44,150,1803,5803,16985,4072,12685,1925,8335,2425,41000,151
NC ED,Brunswick,North Carolina,37019,-78.30712128,34.12305832,50985,59.28,20069,24934,26051,41336,9211,242,81,115,376,3326,8699,31466,7494,37114,17045,16358,3711,70600,263
NC ED,Camden,North Carolina,37029,-76.18499458,36.36289215,5904,24.6,2180,2960,2944,4388,1481,21,9,5,24,382,1053,3640,829,2466,286,1764,416,59400,209
NC ED,Carteret,North Carolina,37031,-76.72598267,34.80224419,52556,99.92,21238,25968,26588,47445,4385,269,293,164,450,3319,8488,33234,7515,34576,13338,15761,5477,73100,280
NC ED,Chowan,North Carolina,37041,-76.65362004,36.17386818,13506,74.21,5113,6275,7231,8349,5087,24,29,17,95,933,2603,7590,2380,5910,797,3611,1502,60700,179
NC ED,Columbus,North Carolina,37047,-78.6146431,34.21293449,49587,52.86,18459,23379,26208,32897,15181,1370,53,86,242,3357,10244,29325,6661,20513,2054,14000,4459,45800,168
NC ED,Craven,North Carolina,37049,-77.04985809,35.12669182,81613,116.42,29542,40610,41003,58660,21116,319,765,753,1821,6954,15089,50423,9147,32293,2751,18705,10837,65900,302
NC ED,Cumberland,North Carolina,37051,-78.80306625,35.04370117,274566,417.91,91500,142001,132565,170069,87496,4425,5769,6807,13298,24868,51906,180944,16848,98360,6860,52807,38693,63500,318
NC ED,Currituck,North Carolina,37053,-75.95126882,36.314991,13736,53.66,5038,6920,6816,12051,1545,66,51,23,110,1002,2492,8533,1709,7367,2329,4047,991,79200,304
NC ED,Dare,North Carolina,37055,-75.73909378,35.70954132,22746,58.17,9349,11306,11440,21766,811,37,79,53,199,1558,3531,14816,2841,21567,12218,6648,2701,108100,416
NC ED,Duplin,North Carolina,37061,-77.92535782,34.94874191,39995,48.83,14925,19182,20813,25927,13259,104,47,658,1015,2770,7784,23846,5595,16395,1470,11334,3591,42600,156
NC ED,Durham,North Carolina,37063,-78.86114502,36.04585075,181835,610.18,72297,85765,96070,109886,67654,425,3233,637,2054,12999,28411,120933,19492,77710,5413,38293,34004,85500,355
NC ED,Edgecombe,North Carolina,37065,-77.58625793,35.90843391,56558,111.77,20319,25845,30713,24665,31661,73,68,91,255,4260,11759,33596,6943,21827,1508,12557,7762,47100,191
NC ED,Franklin,North Carolina,37069,-78.27715683,36.03778267,36414,73.71,13503,17483,18931,23288,12843,74,63,146,290,2436,6401,22711,4866,14957,1454,10193,3310,55500,188
NC ED,Gates,North Carolina,37073,-76.70701218,36.4248848,9305,27.53,3352,4597,4708,5101,4180,8,13,3,21,678,1695,5571,1361,3696,344,2719,633,49700,135
NC ED,Granville,North Carolina,37077,-78.63458252,36.28009987,38345,71.81,13134,18988,19357,23069,14909,99,100,168,356,2529,6708,24354,4754,14164,1030,9636,3498,59100,207
NC ED,Greene,North Carolina,37079,-77.65223312,35.49683571,15384,57.83,5395,7657,7727,8747,6521,16,6,94,169,999,2994,9504,1887,5944,549,3793,1602,48600,160
NC ED,Halifax,North Carolina,37083,-77.62366104,36.25230217,55516,76.68,20335,26352,29164,26009,27586,1711,145,65,237,4021,11304,32255,7936,22480,2145,13288,7047,44800,178
NC ED,Harnett,North Carolina,37085,-78.87769699,35.38441086,67822,112.85,25150,32928,34894,51117,15315,601,299,490,1159,5246,12040,42614,7922,27896,2746,17205,7945,50800,214
NC ED,Hertford,North Carolina,37091,-76.96258163,36.39326096,22523,63.27,8150,10444,12079,9214,12970,228,94,17,81,1598,4509,13131,3285,8870,720,5589,2561,44900,176
NC ED,Hyde,North Carolina,37095,-76.19876099,35.38621902,5411,8.67,2094,2650,2761,3596,1781,4,3,27,43,343,1016,3153,899,2905,811,1613,481,43700,158
NC ED,Johnston,North Carolina,37101,-78.38714981,35.53230095,81306,102.27,31566,39256,42050,65773,14389,178,159,807,1262,5569,14534,50928,10275,34172,2606,22079,9487,59400,208
NC ED,Jones,North Carolina,37103,-77.39046478,35.00710678,9414,20.03,3492,4429,4985,5687,3677,8,19,23,53,725,1778,5564,1347,3829,337,2726,766,43700,164
NC ED,Lenoir,North Carolina,37107,-77.61137009,35.21118164,57274,142.47,21938,26722,30552,34322,22539,70,151,192,463,3682,11203,34533,7856,23739,1801,13834,8104,52400,175
NC ED,Martin,North Carolina,37117,-77.09418869,35.85905457,25078,54.4,9317,11777,13301,13788,11186,20,40,44,99,1761,4933,14756,3628,10104,787,6409,2908,46600,160
NC ED,Nash,North Carolina,37127,-77.97752762,35.96052933,76677,141.99,29041,36382,40295,51874,24142,218,223,220,606,5257,14313,47593,9514,31024,1983,18698,10343,63200,228
NC ED,New Hanover,North Carolina,37129,-77.88822556,34.22500229,120284,650.18,48139,57071,63213,94895,24097,435,616,241,924,7450,19911,77801,15122,57076,8937,30193,17946,72000,324
NC ED,Northampton,North Carolina,37131,-77.48825836,36.35952568,20798,38.66,7591,10059,10739,8397,12328,42,11,20,116,1303,3900,12091,3504,8974,1383,5818,1773,38100,129
NC ED,Onslow,North Carolina,37133,-77.40961456,34.7205143,149838,196.38,40658,89617,60221,111939,29808,939,2994,4158,8035,13588,22716,106863,6671,47526,6868,21835,18823,62200,316
NC ED,Pamlico,North Carolina,37137,-76.74850845,35.14715004,11372,33.35,4523,5457,5915,8362,2951,33,20,6,61,716,1994,6750,1912,6050,1527,3667,856,54300,219
NC ED,Pasquotank,North Carolina,37139,-76.30758667,36.32579613,31298,137.27,11384,14694,16604,19403,11583,59,184,69,246,2473,5996,18483,4346,12298,914,7426,3958,59300,242
NC ED,Pender,North Carolina,37141,-77.90052032,34.51698875,28855,32.98,11112,14010,14845,19828,8770,76,44,137,273,1949,5164,17630,4112,15437,4325,9182,1930,60200,242
NC ED,Perquimans,North Carolina,37143,-76.43499756,36.22684479,10447,42.47,3988,5000,5447,6979,3426,18,20,4,28,690,1882,5967,1908,4972,984,3061,927,53200,193
NC ED,Pitt,North Carolina,37147,-77.40104675,35.57598686,107924,164.27,40491,51312,56612,70643,35921,214,709,437,977,7715,18389,71183,10637,43070,2579,23516,16975,65300,250
NC ED,Robeson,North Carolina,37155,-79.1296463,34.62919807,105179,110.83,36154,49714,55465,37986,26185,40511,239,258,704,8484,23792,61641,11262,39045,2891,25360,10794,44200,165
NC ED,Sampson,North Carolina,37163,-78.39007568,34.93443489,47297,49.94,17526,22473,24824,30273,15686,876,75,387,727,3094,9351,28075,6777,19183,1657,12779,4747,46500,172
NC ED,Tyrrell,North Carolina,37177,-76.21737289,35.78577042,3856,9.47,1471,1842,2014,2297,1543,4,5,7,11,252,812,2114,678,1907,436,1124,347,37400,155
NC ED,Vance,North Carolina,37181,-78.40000916,36.35385323,38892,156.19,14166,18354,20538,21146,17512,69,60,105,271,2889,7506,23436,5061,15743,1577,9248,4918,53100,181
NC ED,Wake,North Carolina,37183,-78.62667847,35.793293,423380,495.76,165743,207214,216166,324011,88057,1148,8177,1987,5396,30174,67641,292372,33193,177146,11403,101003,64740,97200,392
NC ED,Warren,North Carolina,37185,-78.11005402,36.37444496,17265,40.43,6305,8272,8993,6593,9847,763,14,48,98,1142,3207,9823,3093,8714,2409,4818,1487,48200,130
NC ED,Washington,North Carolina,37187,-76.59825134,35.83829117,13997,42.16,5052,6648,7349,7556,6366,13,35,27,65,1029,2852,8178,1938,5644,592,3719,1333,45500,171
NC ED,Wayne,North Carolina,37191,-78.05711746,35.36942482,104666,188.93,36889,52073,52593,69172,33793,265,839,597,1356,7932,19438,66566,10730,39483,2594,23140,13749,58000,213
NC ED,Wilson,North Carolina,37195,-77.92907333,35.71437645,66061,176.63,25093,30871,35190,40623,24896,70,177,295,537,4378,12850,40417,8416,26662,1569,14869,10224,59600,205
NC MD,Alamance,North Carolina,37001,-79.38948822,36.04156303,108213,249.91,42652,51315,56898,86373,20822,303,487,228,736,6847,16828,68473,16065,45312,2660,30643,12009,65300,279
NC MD,Cabarrus,North Carolina,37025,-80.53723526,35.34724045,98935,271.8,37515,47841,51094,85286,12853,313,375,108,483,6783,17114,61990,13048,39713,2198,27634,9881,65500,270
NC MD,Caswell,North Carolina,37033,-79.3374176,36.39172554,20693,48.35,7468,10096,10597,12155,8436,26,20,56,136,1242,3677,12807,2967,8254,786,5866,1602,47300,162
NC MD,Chatham,North Carolina,37037,-79.23053741,35.68919754,38759,54.74,15293,18807,19952,29423,8845,125,69,297,564,2685,6001,24480,5593,16642,1349,11789,3504,63600,278
NC MD,Davidson,North Carolina,37057,-80.25876236,35.76333618,126677,231.16,48944,62097,64580,113296,12314,395,477,195,602,8252,22068,81131,15226,53266,4322,36046,12898,60800,246
NC MD,Davie,North Carolina,37059,-80.53384018,35.897995,27859,104.34,10785,13670,14189,25194,2482,86,53,44,129,1610,4916,17496,3837,11496,711,8855,1930,68000,249
NC MD,Forsyth,North Carolina,37067,-80.26696014,36.11250877,265878,645.33,107419,125379,140499,196918,66102,551,1662,645,2102,18059,42349,172933,32537,115715,8296,68169,39250,75700,302
NC MD,Guilford,North Carolina,37081,-79.78659058,36.07060051,347420,533.67,137706,164204,183216,249584,91655,1637,3726,818,2887,22718,54999,228405,41298,146812,9106,84454,53252,79400,340
NC MD,Hoke,North Carolina,37093,-79.24448395,35.0175457,22856,58.46,7405,11448,11408,9635,9878,3176,85,82,218,1897,5081,13763,2115,7999,594,5575,1830,44800,217
NC MD,Lee,North Carolina,37105,-79.16848755,35.46457672,41374,159.75,15689,19948,21426,31216,9401,169,191,397,800,2967,7789,25207,5411,16954,1265,11386,4303,61100,242
NC MD,Montgomery,North Carolina,37123,-79.89468765,35.32125854,23346,47.64,8290,11763,11583,16773,6001,92,150,330,556,1572,4449,14138,3187,10421,2131,6389,1901,43900,196
NC MD,Moore,North Carolina,37125,-79.43044281,35.2752037,59013,84.18,23827,28156,30857,47464,10882,309,150,208,470,3597,9739,33423,12254,27358,3531,18497,5330,80300,260
NC MD,Orange,North Carolina,37135,-79.11095047,36.04481506,93851,234.63,36104,44471,49380,75871,14893,286,2361,440,1279,5331,12416,67968,8136,38683,2579,19948,16156,101500,389
NC MD,Person,North Carolina,37145,-78.97798538,36.38881683,30180,75.83,11423,14432,15748,20740,9106,181,15,138,249,2063,5356,18486,4275,12548,1125,8284,3139,55700,203
NC MD,Randolph,North Carolina,37151,-79.80111313,35.71125603,106546,135.04,41096,52052,54494,99042,6367,453,358,326,734,7356,18361,67855,12974,43634,2538,31637,9459,60200,248
NC MD,Richmond,North Carolina,37153,-79.76026917,34.98952866,44518,93.33,16793,21260,23258,30816,12869,502,195,136,293,3001,8772,26426,6319,18218,1425,12137,4656,40000,191
NC MD,Rockingham,North Carolina,37157,-79.7679863,36.39202309,86064,151.25,33446,40970,45094,67893,17548,149,190,284,620,5613,14819,53290,12342,35657,2211,24864,8582,48800,209
NC MD,Rowan,North Carolina,37159,-80.47401428,35.67327881,110605,213.11,42512,53692,56913,91851,17773,262,444,275,651,7459,18737,67516,16893,46264,3752,31276,11236,54600,252
NC MD,Scotland,North Carolina,37165,-79.50696564,34.83572388,33754,105.81,11837,15764,17990,19025,12176,2430,83,40,318,2436,7495,20074,3749,12759,922,8220,3617,48000,202
NC MD,Stanly,North Carolina,37167,-80.27684784,35.327425,51765,130.72,19747,24940,26825,45269,5972,155,249,120,309,3689,9012,31487,7577,21808,2061,15127,4620,52800,227
NC MD,Stokes,North Carolina,37169,-80.23853302,36.40063858,37223,82.35,14123,18278,18945,34917,2069,52,79,106,254,2364,6713,23869,4277,15160,1037,11436,2687,59100,238
NC MD,Surry,North Carolina,37171,-80.70054245,36.39954758,61704,114.48,24252,29562,32142,58383,2780,66,84,391,602,3694,10427,38455,9128,26022,1770,18580,5672,48600,206
NC MD,Yadkin,North Carolina,37197,-80.65911102,36.16084862,30488,90.74,12068,14799,15689,28884,1295,22,26,261,388,1828,5012,19119,4529,12921,853,9795,2273,52900,199
NC WD,Alexander,North Carolina,37003,-81.16745758,35.90341759,27544,106.35,10331,13712,13832,25667,1673,52,49,103,184,1735,5038,17738,3033,11197,866,8507,1824,58100,224
NC WD,Alleghany,North Carolina,37005,-81.1254921,36.4691143,9590,40.81,3894,4625,4965,9338,177,8,5,62,85,468,1587,5754,1781,5344,1450,3114,780,48300,175
NC WD,Anson,North Carolina,37007,-80.0894928,35.00622177,23474,44.04,8531,10995,12479,12264,11106,69,27,8,67,1564,4780,13445,3685,9255,724,6439,2092,41600,186
NC WD,Ashe,North Carolina,37009,-81.49048233,36.41200256,22209,52.13,8848,10748,11461,21960,144,21,31,53,102,1123,3680,13603,3803,11119,2271,7314,1534,57600,181
NC WD,Avery,North Carolina,37011,-81.90501404,36.09819794,14867,60.19,5520,7441,7426,14596,158,23,23,67,118,845,2493,9348,2181,8923,3403,4471,1049,55100,214
NC WD,Buncombe,North Carolina,37021,-82.52590942,35.61721802,174821,265.28,70802,82978,91843,158979,14336,486,765,255,1173,10950,27985,107666,28220,77951,7149,49789,21013,64400,281
NC WD,Burke,North Carolina,37023,-81.68112564,35.77397537,75744,150.29,29184,37049,38695,69521,5178,133,794,118,344,4769,13038,48084,9853,31575,2391,21842,7342,52800,235
NC WD,Caldwell,North Carolina,37027,-81.56404495,35.9338131,70709,150.13,27172,34665,36044,66506,3881,105,111,106,315,4551,12136,45473,8549,29454,2282,20317,6855,51600,238
NC WD,Catawba,North Carolina,37035,-81.22745895,35.68344116,118412,299.02,45700,57536,60876,106370,10689,232,830,291,921,7650,20635,75953,14174,49192,3492,33286,12414,62400,281
NC WD,Cherokee,North Carolina,37039,-84.00974274,35.14037323,20170,44.62,7966,9688,10482,19313,361,405,42,49,131,1067,3504,11774,3825,10319,2353,6454,1512,52900,181
NC WD,Clay,North Carolina,37043,-83.7507782,35.06856537,7155,33.43,2928,3485,3670,7061,41,39,7,7,40,343,1272,4087,1453,4158,1230,2472,456,56500,172
NC WD,Cleveland,North Carolina,37045,-81.53839111,35.36414528,84714,181.01,32037,40623,44091,66362,17741,114,394,103,376,5735,15039,52415,11525,34232,2195,23322,8715,53400,227
NC WD,Gaston,North Carolina,37071,-81.18567657,35.28120041,175093,490.46,65347,84130,90963,150868,22676,397,915,237,864,12406,31777,109817,21093,69133,3786,45285,20062,57700,253
NC WD,Graham,North Carolina,37075,-83.8056221,35.33870506,7196,24.9,2772,3573,3623,6731,1,454,6,4,29,411,1286,4340,1159,4132,1360,2266,506,47400,145
NC WD,Haywood,North Carolina,37087,-83.00150681,35.54130936,46942,84.58,19211,22382,24560,46011,648,180,67,36,240,2601,7145,28652,8544,23975,4764,14817,4394,59600,214
NC WD,Henderson,North Carolina,37089,-82.50099564,35.32232475,69285,185.25,28709,33116,36169,66158,2361,197,286,283,846,3808,10769,39569,15139,34131,5422,22021,6688,78400,288
NC WD,Iredell,North Carolina,37097,-80.89923096,35.78007889,92931,161.9,35573,44927,48004,77207,14869,193,356,306,672,6270,16165,58264,12232,39191,3618,26713,8860,63300,265
NC WD,Jackson,North Carolina,37099,-83.14191437,35.25686646,26846,54.68,9683,12947,13899,23609,425,2667,109,36,155,1333,4079,17742,3692,14052,4369,7324,2359,63000,224
NC WD,Lincoln,North Carolina,37109,-81.2329216,35.47935677,50319,168.86,18764,24748,25571,45710,4108,120,172,209,570,3508,9002,31923,5886,20189,1425,14809,3955,60500,244
NC WD,Macon,North Carolina,37113,-83.42290497,35.15568352,23499,45.45,9834,11272,12227,22919,385,76,60,59,165,1200,3465,13556,5278,17174,7340,8139,1695,62500,240
NC WD,Madison,North Carolina,37115,-82.68428421,35.86395073,16953,37.59,6488,8316,8637,16744,136,19,32,22,86,929,2768,10422,2834,7667,1179,5050,1438,47800,161
NC WD,McDowell,North Carolina,37111,-82.05347824,35.73698997,35681,81.65,13680,17389,18292,33901,1479,72,200,29,114,2206,6322,22001,5152,15091,1411,10543,3137,45100,202
NC WD,Mecklenburg,North Carolina,37119,-80.80259705,35.25556946,511433,968.62,200219,245660,265773,364651,134468,1936,8461,1917,6693,38451,85002,340164,47816,216416,16197,119563,80656,86900,383
NC WD,Mitchell,North Carolina,37121,-82.1958847,35.98274803,14433,65.01,5779,6930,7503,14354,23,19,19,18,50,818,2291,8770,2554,6983,1204,4765,1014,48700,196
NC WD,Polk,North Carolina,37149,-82.16127396,35.2906456,14416,60.57,6110,6757,7659,13276,1053,17,25,45,115,764,2029,8071,3552,7273,1163,4883,1227,68200,234
NC WD,Rutherford,North Carolina,37161,-81.98152161,35.39209175,56918,100.21,22198,27371,29547,50133,6514,95,98,78,342,3679,10202,34162,8875,25220,3022,16211,5987,46300,216
NC WD,Swain,North Carolina,37173,-83.55586243,35.48161507,11268,21.42,4173,5614,5654,7950,196,3075,31,16,78,747,2108,6680,1733,5664,1491,3185,988,49100,160
NC WD,Transylvania,North Carolina,37175,-82.81105804,35.22111893,25520,67.51,9924,12472,13048,24121,1189,79,99,32,154,1430,4142,15221,4727,12893,2969,7828,2096,72200,257
NC WD,Union,North Carolina,37179,-80.55764389,35.01029015,84211,131.79,29307,41286,42925,70023,13427,294,257,210,675,6481,16529,53076,8125,30760,1453,22237,7070,70600,308
NC WD,Watauga,North Carolina,37189,-81.68098068,36.24817276,36952,117.68,13693,18063,18889,35930,768,59,152,43,249,1714,4608,26699,3931,19538,5845,8786,4907,73200,312
NC WD,Wilkes,North Carolina,37193,-81.20848465,36.21023941,59393,78.98,23021,29052,30341,56237,2824,69,100,163,362,3532,10438,37587,7836,24960,1939,18271,4750,52800,213
NC WD,Yancey,North Carolina,37199,-82.31289291,35.88803101,15419,49.11,6124,7463,7956,15221,151,27,11,9,49,898,2536,9342,2643,7994,1870,4951,1173,51300,179
ND D,Adams,North Dakota,38001,-102.4983635,46.11004257,3174,3.21,1266,1569,1605,3161,3,10,0,0,1,214,613,1666,681,1504,238,891,375,34000,189
ND D,Barnes,North Dakota,38003,-98.07588959,46.93725395,12545,8.37,4975,6120,6425,12409,27,57,40,12,34,809,2283,6810,2643,5801,826,3407,1568,38400,198
ND D,Benson,North Dakota,38005,-99.18964005,48.11256218,7198,5.1,2415,3631,3567,4417,0,2772,3,6,24,715,1787,3576,1120,3163,748,1646,769,18900,132
ND D,Billings,North Dakota,38007,-103.3541794,46.98194695,1108,0.96,387,579,529,1105,0,3,0,0,0,84,280,618,126,533,146,300,87,50800,222
ND D,Bottineau,North Dakota,38009,-100.823822,48.77130127,8011,4.8,3105,4030,3981,7928,6,58,15,4,16,486,1577,4273,1675,4661,1556,2431,674,37400,193
ND D,Bowman,North Dakota,38011,-103.5208244,46.11099434,3596,3.09,1420,1761,1835,3585,0,4,4,3,6,233,776,1923,664,1691,271,1121,299,44000,171
ND D,Burke,North Dakota,38013,-102.4789391,48.77462578,3002,2.69,1252,1506,1496,2981,1,11,6,3,14,138,604,1555,705,1691,439,1024,228,19900,160
ND D,Burleigh,North Dakota,38015,-100.5184403,46.98099709,60131,37.16,22684,29172,30959,58106,66,1596,239,124,361,4532,12212,36976,6411,23803,1119,14704,7980,67500,315
ND D,Cass,North Dakota,38017,-97.23486328,46.93755722,102874,58.22,40281,51181,51693,100442,280,944,986,222,700,7593,18097,67058,10126,42407,2126,22073,18208,67900,315
ND D,Cavalier,North Dakota,38019,-98.46185684,48.77326775,6064,4.02,2375,3032,3032,6011,4,45,4,0,8,427,1206,3243,1188,3038,663,1893,482,39300,193
ND D,Dickey,North Dakota,38021,-98.50923538,46.10729599,6107,5.36,2299,3026,3081,6055,8,21,13,10,33,355,1172,3266,1314,2763,464,1611,688,32900,180
ND D,Divide,North Dakota,38023,-103.4734268,48.81837654,2899,2.25,1193,1447,1452,2880,1,9,6,3,7,159,533,1430,777,1667,474,950,243,27600,172
ND D,Dunn,North Dakota,38025,-102.6347122,47.40406227,4005,2.01,1433,2065,1940,3605,0,382,6,12,26,330,907,2104,664,2057,624,1123,310,27300,145
ND D,Eddy,North Dakota,38027,-98.90389252,47.72151184,2951,4.65,1194,1458,1493,2900,0,49,1,1,4,172,566,1489,724,1470,276,854,340,27400,207
ND D,Emmons,North Dakota,38029,-100.2622948,46.28805351,4830,3.22,1849,2464,2366,4821,0,5,4,0,7,315,928,2553,1034,2200,351,1520,329,31500,143
ND D,Foster,North Dakota,38031,-98.88718414,47.45996666,3983,6.22,1541,1947,2036,3956,0,22,2,3,10,276,818,2065,824,1876,335,1141,400,36500,189
ND D,Golden Valley,North Dakota,38033,-103.8257408,46.93581009,2108,2.1,811,1073,1035,2087,0,12,8,1,1,135,516,1022,435,1035,224,613,198,31800,191
ND D,Grand Forks,North Dakota,38035,-97.39739227,47.93465042,70683,49.09,25340,36142,34541,66766,1446,1244,881,346,1053,5905,12472,46121,6185,27085,1745,12345,12995,62700,320
ND D,Grant,North Dakota,38037,-101.5750198,46.36568642,3549,2.14,1374,1799,1750,3510,1,32,5,1,10,227,715,1853,754,2011,637,1118,256,24100,139
ND D,Griggs,North Dakota,38039,-98.23418045,47.46043205,3303,4.67,1294,1641,1662,3289,0,8,5,1,4,202,655,1651,795,1660,366,982,312,29500,163
ND D,Hettinger,North Dakota,38041,-102.4646416,46.41892433,3445,3.04,1341,1710,1735,3431,0,7,6,1,3,244,656,1772,773,1637,296,1100,241,24900,140
ND D,Kidder,North Dakota,38043,-99.78555679,46.98235893,3332,2.45,1247,1717,1615,3328,0,0,4,0,7,204,712,1751,665,1672,425,1045,202,22600,139
ND D,La Moure,North Dakota,38045,-98.53998184,46.45876884,5383,4.68,2075,2725,2658,5371,0,5,2,5,8,334,1131,2718,1200,2434,359,1641,434,22300,147
ND D,Logan,North Dakota,38047,-99.47852325,46.46019554,2847,2.85,1096,1438,1409,2838,1,5,1,2,9,173,533,1489,652,1335,239,949,147,20900,143
ND D,McHenry,North Dakota,38049,-100.6323586,48.24314499,6528,3.46,2551,3309,3219,6498,4,13,11,2,13,393,1377,3398,1360,3320,769,2056,495,22600,143
ND D,McIntosh,North Dakota,38051,-99.44250107,46.11149788,4021,4.09,1687,1941,2080,4007,1,6,6,1,6,225,648,1970,1178,2031,344,1381,306,20300,141
ND D,McKenzie,North Dakota,38053,-103.3062553,47.73856163,6383,2.32,2301,3231,3152,5442,3,922,3,13,54,577,1534,3392,880,3178,877,1710,591,43900,155
ND D,McLean,North Dakota,38055,-101.0393542,47.50594521,10457,5.06,3933,5280,5177,9870,3,561,9,14,38,679,2374,5388,2016,5515,1582,3106,827,40100,178
ND D,Mercer,North Dakota,38057,-101.7345734,47.28198051,9808,9.39,3560,4948,4860,9519,12,226,37,14,42,862,2317,5384,1245,4496,936,2862,698,52200,215
ND D,Morton,North Dakota,38059,-101.3332214,46.63301849,23700,12.34,8677,11724,11976,23200,13,420,47,20,74,1709,5452,13345,3194,9467,790,6346,2331,51100,265
ND D,Mountrial,North Dakota,38061,-102.3798828,48.1557312,7021,3.82,2587,3469,3552,5606,4,1395,14,2,25,505,1603,3624,1289,3675,1088,1951,636,31400,143
ND D,Nelson,North Dakota,38063,-98.20449066,47.93572998,4410,4.45,1831,2182,2228,4396,2,7,3,2,8,237,790,2209,1174,2261,430,1392,439,23900,151
ND D,Oliver,North Dakota,38065,-101.3201904,47.14083862,2381,3.29,809,1237,1144,2340,0,40,0,1,4,187,613,1310,271,968,159,691,118,47300,176
ND D,Pembina,North Dakota,38067,-97.5218277,48.77254677,9238,8.25,3555,4577,4661,8997,14,148,12,67,87,619,1972,4935,1712,4294,739,2751,804,41700,191
ND D,Pierce,North Dakota,38069,-99.88835144,48.19839478,5052,4.87,1974,2498,2554,5011,2,23,15,1,1,272,1015,2542,1223,2355,381,1458,516,35400,204
ND D,Ramsey,North Dakota,38071,-98.75353622,48.23010826,12681,10.22,4977,6221,6460,12022,21,591,30,17,49,883,2462,7021,2315,5616,639,3190,1787,45700,241
ND D,Ransom,North Dakota,38073,-97.66255951,46.45644188,5921,6.87,2284,3027,2894,5889,4,13,7,8,24,369,1162,3107,1283,2569,285,1710,574,32200,171
ND D,Renville,North Dakota,38075,-101.5413475,48.73014832,3160,3.62,1209,1560,1600,3107,14,23,11,5,6,178,695,1667,620,1558,349,949,260,35000,198
ND D,Richland,North Dakota,38077,-96.91746521,46.28284454,18148,12.64,6518,9301,8847,17614,21,414,82,17,46,1301,3616,10306,2925,7394,876,4489,2029,43800,235
ND D,Rolette,North Dakota,38079,-99.84152603,48.77100945,12772,13.97,4150,6262,6510,4211,28,8497,13,23,65,1414,3463,6565,1330,4742,592,2692,1458,39400,108
ND D,Sargent,North Dakota,38081,-97.62363434,46.1063633,4549,5.31,1763,2335,2214,4528,1,10,5,5,10,295,929,2512,813,2057,294,1400,363,25000,157
ND D,Sheridan,North Dakota,38083,-100.3557625,47.59043884,2148,2.17,858,1114,1034,2138,0,9,1,0,1,135,381,1133,499,1061,203,730,128,14999,140
ND D,Sioux,North Dakota,38085,-100.9008233,46.18564415,3761,3.42,1022,1945,1816,906,3,2836,12,4,29,460,1161,1905,235,1175,153,446,576,20700,122
ND D,Slope,North Dakota,38087,-103.4860878,46.45416069,907,0.74,333,478,429,903,0,3,0,1,1,63,209,522,113,481,148,273,60,14999,99
ND D,Stark,North Dakota,38089,-102.6644516,46.8211937,22832,17.06,8479,11223,11609,22555,17,144,79,37,126,1790,4983,13046,3013,9585,1106,5827,2652,42800,226
ND D,Steele,North Dakota,38091,-97.72030258,47.45982552,2420,3.39,991,1215,1205,2415,0,2,2,1,5,159,473,1295,493,1311,320,749,242,24800,162
ND D,Stutsman,North Dakota,38093,-98.96335983,46.98098755,22241,9.83,8661,10853,11388,21930,51,141,96,23,84,1487,4298,12850,3606,9770,1109,5691,2970,45400,246
ND D,Towner,North Dakota,38095,-99.24802399,48.68650055,3627,3.5,1433,1817,1810,3566,2,53,5,1,5,287,688,1834,818,1770,337,1015,418,30900,206
ND D,Traill,North Dakota,38097,-97.15861893,47.45721817,8752,10.16,3327,4286,4466,8618,12,44,22,56,101,553,1691,4729,1779,3770,443,2363,964,40200,213
ND D,Walsh,North Dakota,38099,-97.71502686,48.3709774,13840,10.73,5229,6890,6950,13453,17,97,59,214,441,973,2844,7418,2605,6093,864,3921,1308,41900,218
ND D,Ward,North Dakota,38101,-101.5985031,48.32815361,57921,28.38,21485,28824,29097,54545,1411,962,594,409,857,5011,11241,35158,6511,23585,2100,12833,8652,54200,278
ND D,Wells,North Dakota,38103,-99.6715889,47.59119797,5864,4.55,2406,2835,3029,5849,2,6,3,4,7,367,1067,3018,1412,2869,463,1797,609,29100,168
ND D,Williams,North Dakota,38105,-103.4384117,48.30380821,21129,10.19,8041,10386,10743,20025,18,1010,43,33,110,1593,4733,11795,3008,10180,2139,5689,2352,43100,212
NE D,Adams,Nebraska,31001,-98.49597549,40.52131271,29625,52.53,11593,14317,15308,29084,181,105,113,142,303,2118,5250,17309,4948,12491,898,7475,4118,44800,250
NE D,Antelope,Nebraska,31003,-98.06586838,42.17462158,7965,9.27,3045,3912,4053,7930,2,20,9,4,5,656,1780,3978,1551,3478,433,2254,791,26100,137
NE D,Arthur,Nebraska,31005,-101.6958618,41.56423759,462,0.65,187,233,229,459,0,2,0,1,0,36,83,258,85,242,55,113,74,23200,132
NE D,Banner,Nebraska,31007,-103.7116509,41.54317665,852,1.14,305,429,423,832,1,3,0,16,19,66,187,471,128,366,61,192,113,32500,125
NE D,Blaine,Nebraska,31009,-99.97282028,41.90916443,675,0.95,268,329,346,671,1,1,0,2,0,41,147,374,113,381,113,173,95,22300,99
NE D,Boone,Nebraska,31011,-98.05764771,41.69763374,6667,9.7,2560,3330,3337,6648,2,11,1,5,17,534,1411,3387,1335,2878,318,1872,688,30500,155
NE D,Box Butte,Nebraska,31013,-103.0746155,42.21559525,13130,12.19,4898,6478,6652,12501,49,302,57,221,722,1066,3182,7124,1758,5534,636,3326,1572,44000,223
NE D,Boyd,Nebraska,31015,-98.78210449,42.87539482,2835,5.33,1148,1401,1434,2810,0,22,1,2,6,175,592,1355,713,1538,390,910,238,16800,126
NE D,Brown,Nebraska,31017,-99.92891693,42.45573235,3657,3.01,1499,1763,1894,3636,1,11,7,2,21,256,725,1890,786,1950,451,1103,396,29400,180
NE D,Buffalo,Nebraska,31019,-99.06859207,40.84802246,37447,39.63,13736,18248,19199,36430,166,118,162,571,1023,2706,6924,23273,4544,14538,802,8491,5245,49500,255
NE D,Burt,Nebraska,31021,-96.31400299,41.86650658,7868,16.19,3139,3814,4054,7749,8,70,14,27,74,518,1601,4047,1702,3740,601,2233,906,29600,161
NE D,Butler,Nebraska,31023,-97.13478851,41.25035286,8601,14.73,3253,4272,4329,8560,10,17,13,1,20,605,1805,4438,1753,3801,548,2445,808,30200,188
NE D,Cass,Nebraska,31025,-96.14557266,40.92556381,21318,38.27,7797,10641,10677,21033,42,109,71,63,195,1687,4448,12407,2776,8951,1154,5984,1813,48200,245
NE D,Cedar,Nebraska,31027,-97.24967957,42.60642815,10131,13.69,3652,5060,5071,10099,6,14,9,3,17,844,2299,5072,1916,4149,497,2808,844,31100,145
NE D,Chase,Nebraska,31029,-101.6938667,40.52006912,4381,4.9,1704,2143,2238,4349,1,6,2,23,88,329,937,2297,818,2011,307,1276,428,38000,180
NE D,Cherry,Nebraska,31031,-101.1248322,42.53488731,6307,1.06,2438,3127,3180,6107,3,177,14,6,24,515,1259,3466,1067,3023,585,1547,891,35500,193
NE D,Cheyenne,Nebraska,31033,-102.9940605,41.21650505,9494,7.94,3851,4584,4910,9250,8,73,15,148,317,691,1923,5179,1701,4345,494,2711,1140,35700,199
NE D,Clay,Nebraska,31035,-98.04549026,40.52131271,7123,12.41,2741,3457,3666,7067,1,17,13,25,43,473,1467,3788,1395,3173,432,2077,664,28100,167
NE D,Colfax,Nebraska,31037,-97.07704544,41.56152344,9139,22.29,3562,4511,4628,9002,3,32,9,93,224,704,1824,4736,1875,3971,409,2704,858,34300,189
NE D,Cuming,Nebraska,31039,-96.7852211,41.91865158,10117,17.59,3851,5003,5114,10076,8,10,20,3,15,728,2092,5241,2056,4132,281,2760,1091,38500,179
NE D,Custer,Nebraska,31041,-99.72367859,41.38964272,12270,4.77,4953,5928,6342,12152,3,68,12,35,84,841,2473,6261,2695,5728,775,3516,1437,27900,154
NE D,Dakota,Nebraska,31043,-96.53474045,42.39963341,16742,64.89,6035,8294,8448,15481,76,302,358,525,1016,1433,3640,9708,1961,6486,451,4120,1915,43700,267
NE D,Dawes,Nebraska,31045,-103.1365051,42.71531487,9021,6.46,3327,4433,4588,8492,55,355,75,44,142,597,1683,5329,1412,3909,582,2099,1228,33400,204
NE D,Dawson,Nebraska,31047,-99.81107712,40.85577011,19940,20.31,7829,9698,10242,19529,15,65,41,290,663,1406,4166,10909,3459,9021,1192,5458,2371,40800,199
NE D,Deuel,Nebraska,31049,-102.334034,41.10878181,2237,5.12,915,1109,1128,2185,1,10,7,34,102,137,451,1138,511,1075,160,677,238,28800,157
NE D,Dixon,Nebraska,31051,-96.82432556,42.50939369,6143,12.96,2338,3017,3126,6124,4,11,3,1,4,458,1273,3172,1240,2613,275,1735,603,27100,162
NE D,Dodge,Nebraska,31053,-96.61570358,41.56861877,34500,64.61,13445,16493,18007,34132,73,111,119,65,223,2376,6628,19522,5974,14601,1156,9093,4352,42800,236
NE D,Douglas,Nebraska,31055,-96.17933273,41.28957748,416444,1250.58,161113,200576,215868,359438,45541,2481,4086,4898,11368,33314,78584,257213,47333,172335,11222,100977,60136,59900,333
NE D,Dundy,Nebraska,31057,-101.6863899,40.17110634,2582,2.81,1085,1246,1336,2568,0,5,4,5,15,130,513,1343,596,1326,241,754,331,23600,144
NE D,Fillmore,Nebraska,31059,-97.5907135,40.52162933,7103,12.33,2829,3445,3658,7042,14,33,4,10,35,487,1394,3678,1544,3102,273,2110,719,30900,169
NE D,Franklin,Nebraska,31061,-98.94905853,40.17079735,3938,6.84,1655,1897,2041,3915,6,10,6,1,8,258,665,1969,1046,1950,295,1306,349,19300,139
NE D,Frontier,Nebraska,31063,-100.3746185,40.51808357,3101,3.18,1206,1537,1564,3074,1,4,8,14,19,196,667,1689,549,1565,359,866,340,25500,155
NE D,Furnas,Nebraska,31065,-99.90908432,40.17069626,5553,7.7,2334,2671,2882,5515,4,18,6,10,37,287,1029,2718,1519,2905,571,1772,562,19900,135
NE D,Gage,Nebraska,31067,-96.68086243,40.26076889,22794,26.57,9019,10923,11871,22530,45,102,77,40,110,1520,4047,12728,4499,9735,716,6380,2639,36600,205
NE D,Garden,Nebraska,31069,-102.3305244,41.60919571,2460,1.46,1040,1183,1277,2455,0,0,1,4,15,159,412,1298,591,1343,303,714,326,30700,154
NE D,Garfield,Nebraska,31071,-98.98640823,41.90911484,2141,3.76,864,1026,1115,2133,0,3,5,0,3,135,419,1072,515,1021,157,619,245,24000,140
NE D,Gosper,Nebraska,31073,-99.86240387,40.51722908,1928,4.18,764,977,951,1927,0,0,1,0,9,104,366,1049,409,1212,448,590,174,40300,168
NE D,Grant,Nebraska,31075,-101.7452774,41.91037178,769,0.99,303,391,378,760,0,5,3,1,2,64,161,426,118,425,122,192,111,25900,168
NE D,Greeley,Nebraska,31077,-98.51621628,41.56557465,3006,5.27,1133,1480,1526,2999,0,4,3,0,2,209,715,1455,627,1284,151,889,244,19200,136
NE D,Hall,Nebraska,31079,-98.49695587,40.87024879,48925,91.11,18678,23709,25216,47263,145,150,540,827,2116,3819,10054,28102,6950,19528,850,11886,6792,48200,253
NE D,Hamilton,Nebraska,31081,-98.0462532,40.93054581,8862,16.32,3235,4330,4532,8811,9,9,24,9,57,678,1895,4863,1426,3589,354,2245,990,41400,196
NE D,Harlan,Nebraska,31083,-99.40023422,40.17027473,3810,6.86,1585,1830,1980,3804,2,2,1,1,5,244,695,1957,914,2409,824,1232,353,28400,158
NE D,Hayes,Nebraska,31085,-101.0557556,40.51931,1222,1.71,480,626,596,1218,0,2,2,0,6,91,240,671,220,583,103,338,142,19600,142
NE D,Hitchcock,Nebraska,31087,-101.0367699,40.17149925,3750,5.29,1467,1841,1909,3733,0,8,3,6,23,252,831,1866,801,1873,406,1108,359,22700,158
NE D,Holt,Nebraska,31089,-98.77470398,42.4858551,12599,5.24,4744,6270,6329,12537,3,30,17,12,23,1057,2752,6607,2183,5472,728,3318,1426,35200,169
NE D,Hooker,Nebraska,31091,-101.1348801,41.91017342,793,1.1,332,388,405,792,0,0,0,1,14,49,146,378,220,433,101,255,77,26300,158
NE D,Howard,Nebraska,31093,-98.51324081,41.21686935,6055,10.74,2309,2959,3096,6020,1,12,3,19,42,431,1294,3184,1146,2598,289,1717,592,31600,165
NE D,Jefferson,Nebraska,31095,-97.13555527,40.17108154,8759,15.23,3634,4230,4529,8710,4,23,8,14,81,567,1587,4537,2068,4082,448,2768,866,19400,153
NE D,Johnson,Nebraska,31097,-96.25675201,40.39312935,4673,12.4,1940,2252,2421,4541,1,0,107,24,47,267,878,2423,1105,2153,213,1483,457,25900,159
NE D,Kearney,Nebraska,31099,-98.94739532,40.51362419,6629,12.77,2523,3284,3345,6579,0,3,4,43,114,506,1283,3683,1157,2756,233,1822,701,42500,213
NE D,Keith,Nebraska,31101,-101.6472359,41.19489861,8584,8.26,3430,4173,4411,8403,10,49,15,107,336,603,1784,4747,1450,4938,1508,2392,1038,41500,198
NE D,Keya Paha,Nebraska,31103,-99.72566605,42.85408211,1029,1.34,419,538,491,1028,0,1,0,0,1,50,219,543,217,584,165,297,122,17500,117
NE D,Kimball,Nebraska,31105,-103.7130547,41.1952076,4108,4.32,1650,2016,2092,4074,2,9,6,17,146,283,810,2234,781,1967,317,1229,421,35300,197
NE D,Knox,Nebraska,31107,-97.89746475,42.65833855,9534,8.63,3817,4650,4884,9031,0,482,17,4,9,607,1895,4757,2275,4799,982,2803,1014,24900,132
NE D,Lancaster,Nebraska,31109,-96.67945862,40.78445435,213641,254.64,82759,104493,109148,202663,4659,1207,3367,1745,3938,15194,35854,139365,23228,86734,3975,50104,32655,62200,322
NE D,Lincoln,Nebraska,31111,-100.7383728,41.04496002,32508,12.87,12676,15777,16731,31354,95,120,115,824,1623,2360,7020,18172,4956,14210,1534,8605,4071,42900,213
NE D,Logan,Nebraska,31113,-100.479084,41.5657196,878,1.54,320,441,437,873,3,0,0,2,3,71,222,451,134,387,67,213,107,29200,176
NE D,Loup,Nebraska,31115,-99.45140076,41.91036224,683,1.19,276,337,346,682,0,0,1,0,1,49,139,367,128,399,123,201,75,14999,121
NE D,Madison,Nebraska,31119,-97.59900284,41.91231346,32655,56.79,12283,15954,16701,31734,238,238,99,346,569,2667,6644,18528,4816,13069,786,8035,4248,48000,249
NE D,McPherson,Nebraska,31117,-101.0574799,41.56442451,546,0.64,212,276,270,545,1,0,0,0,0,40,120,278,108,257,45,135,77,30600,117
NE D,Merrick,Nebraska,31121,-97.94083786,41.13472748,8042,16.82,3061,3979,4063,7996,3,13,21,9,71,576,1661,4375,1430,3533,472,2234,827,33200,176
NE D,Morrill,Nebraska,31123,-103.0012016,41.71627617,5423,3.86,2083,2685,2738,5202,1,33,7,180,434,401,1119,2883,1020,2530,447,1424,659,28400,175
NE D,Nance,Nebraska,31125,-97.99458313,41.39372826,4275,9.74,1585,2110,2165,4250,1,5,8,11,38,335,894,2207,839,1807,222,1210,375,24300,149
NE D,Nemaha,Nebraska,31127,-95.80364609,40.4145298,7980,19.51,3079,3957,4023,7876,72,13,14,5,20,511,1441,4536,1492,3432,353,2135,944,33500,183
NE D,Nuckolls,Nebraska,31129,-98.04253006,40.17082977,5786,10.05,2359,2782,3004,5774,1,8,0,3,17,343,1155,2931,1357,2699,340,1856,503,22200,139
NE D,Otoe,Nebraska,31131,-96.09634018,40.65996933,14252,23.17,5657,6833,7419,14138,25,31,25,33,106,951,2776,7572,2953,6137,480,4045,1612,38800,208
NE D,Pawnee,Nebraska,31133,-96.22736359,40.12874031,3317,7.66,1408,1597,1720,3304,3,1,4,5,17,213,555,1599,950,1674,266,1137,271,14999,127
NE D,Perkins,Nebraska,31135,-101.6451263,40.84906769,3367,3.8,1283,1670,1697,3320,0,8,8,31,53,226,776,1675,690,1537,254,994,289,36600,177
NE D,Phelps,Nebraska,31137,-99.40535355,40.51104927,9715,17.99,3769,4680,5035,9653,5,15,16,26,91,705,1951,5328,1731,4084,315,2709,1060,39700,198
NE D,Pierce,Nebraska,31139,-97.60019684,42.26201057,7827,13.61,2929,3832,3995,7782,0,25,9,11,14,619,1670,4036,1502,3177,248,2243,686,34200,162
NE D,Platte,Nebraska,31141,-97.53792572,41.53579903,29820,44.57,10954,14645,15175,29523,54,61,74,108,255,2579,6678,16604,3959,11716,762,8038,2916,51900,250
NE D,Polk,Nebraska,31143,-97.59424591,41.21912384,5675,12.99,2223,2789,2886,5632,1,13,11,18,30,344,1170,2857,1304,2742,519,1697,526,30700,160
NE D,Red Willow,Nebraska,31145,-100.4721756,40.169487,11705,16.3,4723,5563,6142,11568,13,28,25,71,210,838,2340,6521,2006,5279,556,3291,1432,39000,215
NE D,Richardson,Nebraska,31147,-95.6558609,40.12940598,9937,17.97,4120,4771,5166,9738,5,176,11,7,44,695,1778,5101,2363,4704,584,2953,1167,24800,145
NE D,Rock,Nebraska,31149,-99.45225906,42.44148064,2019,2.01,798,995,1024,2017,0,1,0,1,6,144,439,1069,367,1001,203,559,239,26600,147
NE D,Saline,Nebraska,31151,-97.13427353,40.52204895,12715,22.11,4829,6143,6572,12537,16,24,111,27,74,827,2336,6936,2616,5299,470,3541,1288,37500,229
NE D,Sarpy,Nebraska,31153,-96.09334564,41.09823036,102583,431.02,33960,51694,50889,93712,5336,399,1970,1166,3383,9550,23520,64621,4892,35994,2034,21396,12564,66900,411
NE D,Saunders,Nebraska,31155,-96.60629654,41.23700905,18285,24.28,6809,9155,9130,18157,15,46,29,38,104,1365,3854,10147,2919,7594,785,5424,1385,43600,217
NE D,Scotts Bluff,Nebraska,31157,-103.7070694,41.84810066,36025,49.69,14056,17303,18722,32822,70,662,180,2291,5237,2540,7523,20147,5815,15514,1458,9045,5011,40400,231
NE D,Seward,Nebraska,31159,-97.13357544,40.87157822,15450,26.87,5432,7749,7701,15334,20,31,36,29,80,1069,3040,8885,2456,5908,476,3822,1610,48900,234
NE D,Sheridan,Nebraska,31161,-102.3979645,42.49663162,6750,2.75,2618,3285,3465,6200,3,524,16,7,68,405,1477,3467,1401,3211,593,1815,803,28800,178
NE D,Sherman,Nebraska,31163,-98.97067261,41.2185173,3718,6.59,1431,1885,1833,3700,0,3,10,5,8,242,808,1876,792,1874,443,1082,349,16400,142
NE D,Sioux,Nebraska,31165,-103.7293892,42.49822044,1549,0.75,612,777,772,1510,0,1,2,36,44,100,307,891,251,869,257,393,219,27000,171
NE D,Stanton,Nebraska,31167,-97.19183731,41.91558266,6244,14.49,2167,3104,3140,6167,23,37,5,12,23,572,1490,3419,763,2355,188,1650,517,41700,198
NE D,Thayer,Nebraska,31169,-97.58912659,40.1716938,6635,11.54,2669,3212,3423,6595,4,18,7,11,59,382,1255,3270,1728,3017,348,2084,585,24200,162
NE D,Thomas,Nebraska,31171,-100.5534477,41.90996552,851,1.19,316,411,440,847,0,4,0,0,11,52,217,456,126,404,88,225,91,24800,172
NE D,Thurston,Nebraska,31173,-96.54535294,42.1499939,6936,17.74,2288,3427,3509,3861,8,3046,7,14,62,756,1676,3555,949,2548,260,1388,900,30700,127
NE D,Valley,Nebraska,31175,-98.97958374,41.56389999,5169,9.12,2141,2480,2689,5127,6,11,10,15,17,322,1018,2636,1193,2469,328,1537,604,23800,160
NE D,Washington,Nebraska,31177,-96.18658829,41.54029846,16607,43.02,6017,8136,8471,16403,85,39,34,46,104,1063,3491,9801,2252,6378,361,4506,1511,58200,240
NE D,Wayne,Nebraska,31179,-97.09561539,42.2175312,9364,21.14,3232,4527,4837,9257,40,28,34,5,22,642,1615,5793,1314,3517,285,2095,1137,44100,209
NE D,Webster,Nebraska,31181,-98.49349976,40.17019272,4279,7.44,1755,2063,2216,4256,1,6,13,3,11,263,751,2120,1145,2048,293,1376,379,22600,138
NE D,Wheeler,Nebraska,31183,-98.52110672,41.90892601,948,1.65,350,476,472,945,0,0,3,0,0,89,221,498,140,561,211,231,119,18800,125
NE D,York,Nebraska,31185,-97.59125519,40.87056732,14428,25.05,5467,6974,7454,14216,89,48,44,31,112,1143,2820,8013,2452,5861,394,3752,1715,45200,227
NH D,Belknap,New Hampshire,33001,-71.44752884,43.51743698,49216,121.82,18839,24049,25167,48788,67,108,216,37,245,3468,9140,29865,6743,30306,11467,13475,5364,114000,438
NH D,Carroll,New Hampshire,33003,-71.25765228,43.87887001,35410,37.95,14253,17242,18168,35150,66,60,106,28,132,2426,6052,21233,5699,32146,17893,10739,3514,119000,417
NH D,Cheshire,New Hampshire,33005,-72.24229431,42.94355011,70121,98.62,25856,33874,36247,69404,207,147,300,63,334,4944,12122,43867,9188,30350,4494,18215,7641,110600,449
NH D,Coos,New Hampshire,33007,-71.38805771,44.69181061,34828,19.31,13799,16884,17944,34563,37,62,130,36,150,2244,6323,20509,5752,18712,4913,9698,4101,71600,289
NH D,Grafton,New Hampshire,33009,-71.84555435,43.96242905,74929,43.59,27542,36966,37963,73395,404,186,831,113,599,4928,12257,48458,9286,42206,14664,18500,9042,105700,418
NH D,Hillsborough,New Hampshire,33011,-71.6510582,42.95123291,336073,383.64,124567,164450,171623,326821,3001,612,3816,1823,5696,27151,59047,215446,34429,135622,11055,79363,45204,137500,513
NH D,Merrimack,New Hampshire,33013,-71.66716766,43.30703163,120005,128.21,44595,58743,61262,118580,451,224,595,155,780,8957,21404,75067,14577,50870,6275,31088,13507,117800,461
NH D,Rockingham,New Hampshire,33015,-71.09207916,43.00567627,245845,351.71,89118,121947,123898,240203,2326,395,2266,655,2395,19937,44034,159274,22600,101773,12655,64324,24794,149800,541
NH D,Strafford,New Hampshire,33017,-71.02992249,43.32636261,104233,281.71,37744,50468,53765,102308,575,212,937,201,837,7671,16777,68706,11079,42387,4643,24453,13291,116400,453
NH D,Sullivan,New Hampshire,33019,-72.19770432,43.3619976,38592,71.47,14873,18921,19671,38221,64,128,146,33,165,2839,7034,23043,5676,19532,4659,10517,4356,90900,390
NJ D,Atlantic,New Jersey,34001,-74.69497681,39.50345039,224327,394.94,85123,107810,116517,172088,39064,565,4782,7828,16117,16045,35391,140297,32594,106877,21754,54923,30200,105900,503
NJ D,Bergen,New Jersey,34003,-74.08428574,40.94238091,825380,3482.62,308880,396272,429108,717907,40031,1060,54775,11607,49776,48940,119428,530653,126359,324817,15937,209876,99004,227700,627
NJ D,Burlington,New Jersey,34005,-74.72579575,39.85593987,395066,488.94,136554,195266,199800,324731,56545,949,8105,4736,12819,28361,69875,254642,42188,143236,6682,102910,33644,122500,526
NJ D,Camden,New Jersey,34007,-74.94545364,39.79297066,502824,2254.82,178758,241824,261000,385350,81665,1055,11579,23175,36022,39653,93414,308566,61191,190145,11387,124711,54047,99300,440
NJ D,Cape May,New Jersey,34009,-74.79571533,39.13827896,95089,361.56,37856,45675,49414,88097,5334,213,607,838,1855,6377,14685,54896,19131,85537,47681,27242,10614,112800,474
NJ D,Cumberland,New Jersey,34011,-75.13847351,39.36743164,138053,277.21,47118,67364,70689,101467,23318,1311,1134,10823,18348,10125,25824,83447,18657,50294,3176,32299,14819,73900,396
NJ D,Essex,New Jersey,34013,-74.24575424,40.78812408,778206,6127.61,278752,367894,410312,398024,316262,1639,21191,41090,97777,54671,133966,491248,98321,298710,19958,126313,152439,196100,461
NJ D,Gloucester,New Jersey,34015,-75.15706253,39.6954174,230082,703.61,78845,111967,118115,205509,19935,440,2876,1322,4131,17473,44065,143783,24761,82459,3614,61774,17071,99300,437
NJ D,Hudson,New Jersey,34017,-74.07054138,40.73500252,553099,12023.89,208739,268176,284923,380612,79770,1460,36777,54480,183465,36844,85639,360215,70401,229682,20943,67837,140902,157000,464
NJ D,Hunterdon,New Jersey,34019,-74.95543671,40.55683899,107776,253,37906,53741,54035,103768,2217,111,1387,293,1732,7610,18331,71634,10201,39987,2081,30527,7379,209900,630
NJ D,Mercer,New Jersey,34021,-74.70812988,40.27428246,325824,1435.35,116941,157592,168232,244656,61481,533,9992,9162,19665,21771,51575,210249,42229,123666,6725,77816,39125,137900,507
NJ D,Middlesex,New Jersey,34023,-74.42823792,40.42305756,671780,2125.89,238833,330482,341298,550006,53629,1066,44869,22210,59776,44943,99688,448332,78817,250174,11341,160991,77842,164700,608
NJ D,Monmouth,New Jersey,34025,-74.29842377,40.26186752,553124,1171.87,197570,268150,284974,483277,47229,712,15224,6682,22407,38969,95845,347923,70387,218408,20838,143533,54037,180400,567
NJ D,Morris,New Jersey,34027,-74.57704544,40.85743523,421353,896.5,148751,205813,215540,386681,12491,429,16759,4993,19814,27637,68654,280640,44422,155745,6994,110089,38662,217300,659
NJ D,Ocean,New Jersey,34029,-74.29701233,39.84357452,433203,675.82,168147,204181,229022,412709,12035,615,3874,3970,13950,28816,69349,234630,100408,219863,51716,139417,28730,126000,578
NJ D,Passaic,New Jersey,34031,-74.30841827,41.00372505,453060,2422.78,155269,218240,234820,325530,66077,1161,11968,48324,98092,32961,75782,285882,58435,162512,7243,86638,68631,185500,499
NJ D,Salem,New Jersey,34033,-75.31704712,39.57649422,65294,193.18,23794,31446,33848,54394,9567,218,379,736,1436,4322,12415,38999,9558,25349,1555,17198,6596,82700,361
NJ D,Somerset,New Jersey,34035,-74.60024643,40.55820274,240279,787.8,88346,118089,122190,211384,14824,243,10548,3280,10187,16862,36027,161377,26013,92653,4307,66561,21785,196300,639
NJ D,Sussex,New Jersey,34037,-74.68082428,41.12556648,130943,248.94,44456,64967,65976,127831,1242,196,1222,452,2911,10894,25492,82873,11684,51574,7118,36574,7882,156300,594
NJ D,Union,New Jersey,34039,-74.3055687,40.65561295,493819,4794.36,180076,236524,257295,367416,92807,880,13726,18990,67797,32421,75667,311606,74125,187033,6957,112508,67568,180500,530
NJ D,Warren,New Jersey,34041,-74.98926544,40.83312416,91607,255.17,33997,44212,47395,89028,1302,114,747,416,1784,6942,15713,56809,12143,36589,2592,23644,10353,143900,488
NM D,Bernalillo,New Mexico,35001,-106.6584396,35.0489502,480577,411.1,185582,234602,245975,369445,13199,16296,7386,74251,178310,37126,88473,304459,50519,201235,15653,112589,72993,85300,351
NM D,Catron,New Mexico,35003,-108.375267,33.89842033,2563,0.37,1010,1349,1214,2508,7,21,2,25,728,160,522,1490,391,1552,542,771,239,39700,197
NM D,Chaves,New Mexico,35005,-104.4191856,33.30893898,57849,9.54,20589,28448,29401,47790,1197,375,282,8205,21271,4728,12984,31740,8397,23386,2797,14402,6187,44600,267
NM D,Cibola,New Mexico,35006,-108.0508652,34.97024727,23794,5.23,7292,11654,12140,13899,191,9155,81,468,8109,2109,5965,13715,2005,9692,2400,5380,1912,37500,158
NM D,Colfax,New Mexico,35007,-104.675293,36.6067009,12925,3.44,4959,6479,6446,10697,44,95,23,2066,6190,902,2797,7125,2101,8265,3306,3500,1459,46700,192
NM D,Curry,New Mexico,35009,-103.3753243,34.63534546,42207,29.98,15113,20729,21478,31904,2909,279,815,6300,10015,3826,9135,24670,4576,16906,1793,9313,5800,51300,290
NM D,De Baca,New Mexico,35011,-104.4086876,34.38957024,2252,0.97,913,1103,1149,2107,2,42,0,101,736,141,427,1177,507,1329,416,680,233,33000,162
NM D,Dona Ana,New Mexico,35013,-106.8032417,32.42225456,135510,35.48,45029,67383,68127,123434,2172,1009,1164,7731,76448,11647,29553,82417,11893,49148,4119,29084,15945,67300,290
NM D,Eddy,New Mexico,35015,-104.2779274,32.48663139,48605,11.62,17472,23807,24798,39597,826,249,201,7732,17145,3773,10883,26565,7384,20134,2662,12745,4727,44800,238
NM D,Grant,New Mexico,35017,-108.3545189,32.53771973,27676,6.97,9773,13592,14084,25745,137,229,69,1496,14061,2084,6322,15390,3880,11349,1576,6875,2898,50900,201
NM D,Guadalupe,New Mexico,35019,-104.7056274,34.78398705,4156,1.37,1520,2086,2070,3076,12,21,28,1019,3505,314,960,2315,567,2149,629,1078,442,33100,167
NM D,Harding,New Mexico,35021,-103.8948288,35.8106842,987,0.47,396,508,479,787,2,5,1,192,461,66,212,503,206,614,218,308,88,16000,125
NM D,Hidalgo,New Mexico,35023,-108.6266937,32.0631876,5958,1.73,2004,3022,2936,5457,11,20,37,433,2984,477,1496,3298,687,2413,409,1227,777,36700,99
NM D,Lea,New Mexico,35025,-103.4223137,32.78443146,55765,12.71,19306,27539,28226,45817,2611,355,197,6785,16598,4855,13676,31312,5922,23333,4027,13809,5497,39600,241
NM D,Lincoln,New Mexico,35027,-105.616539,33.74354935,12219,2.53,4789,6027,6192,11175,65,132,28,819,3427,812,2293,7216,1898,12622,7833,3466,1323,67400,268
NM D,Los Alamos,New Mexico,35028,-106.2845993,35.88055992,18115,166.19,7213,9182,8933,17064,96,126,428,401,2008,1132,3585,11730,1668,7565,352,5367,1846,126100,403
NM D,Luna,New Mexico,35029,-107.7514191,32.19606972,18110,6.11,6797,8708,9402,16297,253,107,53,1400,8628,1311,3964,9186,3649,7766,969,4836,1961,47200,206
NM D,McKinley,New Mexico,35031,-108.1707001,35.47892189,60686,11.15,16588,29300,31386,13295,295,43570,245,3281,7764,7110,16446,33257,3873,20933,4345,11799,4789,42800,221
NM D,Mora,New Mexico,35033,-105.0178185,36.02169037,4264,2.21,1519,2134,2130,2423,2,21,3,1815,3623,295,949,2390,630,2486,967,1234,285,30200,161
NM D,Otero,New Mexico,35035,-105.6087837,32.69636345,51928,7.84,18155,26296,25632,41313,2755,2984,966,3910,12380,4959,10928,31285,4756,23177,5022,11313,6842,58000,291
NM D,Quay,New Mexico,35037,-103.5697136,35.17255402,10823,3.77,4238,5222,5601,8031,151,109,39,2493,4060,732,2246,6034,1811,5576,1338,3058,1180,37600,196
NM D,Rio Arriba,New Mexico,35039,-106.5640526,36.46991348,34365,5.87,11461,17038,17327,24323,138,5225,58,4621,24955,3176,7967,19894,3328,14357,2896,9218,2243,58800,191
NM D,Roosevelt,New Mexico,35041,-103.4836655,34.08356094,16702,6.81,5991,8133,8569,13317,221,140,99,2925,4548,1233,3299,9910,2260,6902,911,3856,2135,41000,217
NM D,San Juan,New Mexico,35045,-108.2290192,36.49806404,91605,16.59,28740,45008,46597,51806,429,33646,215,5509,12009,8915,24425,51244,7021,34248,5508,20691,8049,58400,272
NM D,San Miguel,New Mexico,35047,-104.66819,35.46804237,25743,5.47,8701,12763,12980,16392,170,222,151,8808,20491,2097,5702,14951,2993,11066,2365,6265,2436,47500,193
NM D,Sandoval,New Mexico,35043,-106.9291611,35.7211895,63319,17.08,20867,31070,32249,43440,939,12491,503,5946,17372,6258,14021,36655,6385,23667,2800,17268,3599,69600,376
NM D,Santa Fe,New Mexico,35049,-105.9722061,35.52692223,98928,51.93,37840,48499,50429,79390,615,2822,513,15588,48939,7207,18490,63181,10050,41464,3624,25621,12219,103300,425
NM D,Sierra,New Mexico,35051,-107.1568375,33.04380226,9912,2.37,4428,4864,5048,9254,39,77,12,530,2379,553,1401,4833,3125,6457,2029,3247,1181,49500,186
NM D,Socorro,New Mexico,35053,-106.8168068,34.03128433,14764,2.23,5217,7493,7271,11423,114,1491,212,1524,7057,1204,3272,8747,1541,6289,1072,3586,1631,52500,221
NM D,Taos,New Mexico,35055,-105.6148682,36.50828743,23118,10.49,8752,11336,11782,16868,63,1571,86,4530,15008,1747,4981,13835,2555,12020,3268,6550,2202,71700,281
NM D,Torrance,New Mexico,35057,-105.8696823,34.65629768,10285,3.08,3670,5164,5121,8951,43,128,23,1140,3892,799,2504,5811,1171,4878,1208,3010,660,46500,233
NM D,Union,New Mexico,35059,-103.4995918,36.37101364,4124,1.08,1615,2012,2112,3966,2,13,4,139,1390,310,855,2218,741,2299,684,1169,446,36200,197
NM D,Valencia,New Mexico,35061,-106.8086586,34.70427895,45235,42.35,15170,22703,22532,35037,500,1329,200,8169,22733,3820,10130,26713,4572,16781,1611,12650,2520,72100,270
NV D,Carson City,Nevada,32510,-119.7607613,39.17000008,40443,277.01,15895,20670,19773,36693,698,1106,569,1377,3110,2727,6310,25365,6041,16628,733,9582,6313,99300,406
NV D,Churchill,Nevada,32001,-118.3282738,39.53935432,17938,3.59,6666,9034,8904,16028,203,895,466,346,1008,1500,3555,10586,2297,7290,624,4204,2462,84500,377
NV D,Clark,Nevada,32003,-114.9607582,35.92639351,741459,94.08,287025,376108,365351,602658,70738,6416,26043,35604,82904,56988,124821,481972,77678,317188,30163,149007,138018,93300,461
NV D,Douglas,Nevada,32005,-119.6551018,38.81790543,27637,39.04,10571,13903,13734,26130,86,570,361,490,1652,2053,5019,17213,3352,14121,3550,7285,3286,121000,539
NV D,Elko,Nevada,32007,-115.5216789,41.05385399,33530,1.96,11777,17841,15689,28970,266,2128,277,1889,4339,3229,7581,20678,2042,13461,1684,7592,4185,81600,359
NV D,Esmeralda,Nevada,32009,-117.7853165,37.70850372,1344,0.37,588,748,596,1171,7,74,8,84,125,85,238,873,148,966,378,355,233,41400,248
NV D,Eureka,Nevada,32011,-116.18256,40.07676506,1547,0.37,617,845,702,1442,5,41,11,48,138,136,289,994,128,817,200,421,196,54600,293
NV D,Humboldt,Nevada,32013,-118.157177,41.26299095,12844,1.32,4538,6903,5941,10761,81,714,63,1225,2335,1099,2796,8015,934,5044,506,3054,1484,74000,361
NV D,Lander,Nevada,32015,-117.1813965,40.04375839,6266,1.14,2212,3251,3015,5663,9,295,16,283,789,616,1525,3754,371,2586,374,1555,657,58300,277
NV D,Lincoln,Nevada,32017,-114.9630737,37.75991631,3775,0.35,1325,1964,1811,3555,81,58,16,65,156,304,978,1894,599,1800,475,974,351,50900,180
NV D,Lyon,Nevada,32019,-119.2098198,39.07211304,20001,9.97,7680,10200,9801,18387,66,623,159,766,1511,1589,3873,11520,3019,8722,1042,5560,2120,74900,313
NV D,Mineral,Nevada,32021,-118.4159927,38.48147774,6475,1.73,2529,3304,3171,5142,351,748,70,164,546,568,1307,3754,846,2994,465,1681,848,56900,328
NV D,Nye,Nevada,32023,-116.5875969,37.58156204,17781,0.98,6664,9501,8280,16393,291,499,155,443,1237,1290,3122,11190,2179,8073,1409,4677,1987,70800,304
NV D,Pershing,Nevada,32027,-118.3054047,40.47379112,4336,0.72,1614,2223,2113,3763,13,204,25,331,662,430,890,2512,504,1908,294,980,634,66500,299
NV D,Storey,Nevada,32029,-119.4765816,39.44365883,2526,9.57,1006,1250,1276,2390,8,51,29,48,96,166,420,1677,263,1085,79,734,272,99500,343
NV D,Washoe,Nevada,32031,-119.5749283,40.57406044,254667,40.31,102294,129088,125579,225095,5680,4921,9824,9147,22959,18730,40149,169648,26140,112193,9899,55335,46959,111200,429
NV D,White Pine,Nevada,32033,-114.9683189,39.40293312,9264,1.04,3296,5047,4217,8454,188,294,35,293,852,707,1858,5609,1090,3982,686,2392,904,53000,285
NY ED,Kings,New York,36047,-73.93730927,40.66021729,2300664,32866.63,828199,1071091,1229573,1078549,872305,7969,111251,230590,462411,178420,427134,1410053,285057,873671,45472,214788,613411,196100,428
NY ED,Nassau,New York,36059,-73.59415817,40.74876404,1287348,4485.53,431515,621793,665555,1115119,111057,1642,39299,20231,77386,78852,201846,823751,182899,446292,14777,347143,84372,209500,678
NY ED,Queens,New York,36081,-73.82879639,40.67728043,1951598,17904.57,720149,927714,1023884,1129192,423211,7050,238336,153809,381120,121590,287037,1254628,288343,752690,32541,305573,414576,191000,513
NY ED,Richmond,New York,36085,-74.14847946,40.57767868,378977,6423.34,130519,183155,195822,322043,30630,715,16941,8648,30239,28227,65835,242602,42313,139726,9207,83138,47381,186300,509
NY ED,Suffolk,New York,36103,-72.67449951,40.88727951,1321864,1451,424719,646460,675404,1190315,82910,2994,23100,22545,87852,92949,233639,853559,141717,481317,56598,340253,84466,165900,696
NY ND,Albany,New York,36001,-73.9650116,42.60673141,292594,558.39,115824,138702,153892,260596,24702,531,4974,1791,5311,18566,44054,187152,42822,124255,8431,66031,49793,110900,402
NY ND,Broome,New York,36007,-75.75503922,42.20504951,212160,297.98,81843,102292,109868,202949,4333,355,3677,846,2478,14516,34065,131754,31825,87969,6126,53520,28323,79000,333
NY ND,Cayuga,New York,36011,-76.50237274,43.0177021,82313,118.44,29075,41119,41194,78320,2995,275,331,392,1202,6097,15484,49134,11598,33280,4205,20604,8471,59800,308
NY ND,Chenango,New York,36017,-75.58738327,42.47221565,51768,57.71,19141,25356,26412,50976,384,145,165,98,476,3901,10431,30209,7227,22164,3023,14240,4901,55900,273
NY ND,Clinton,New York,36019,-73.67457199,44.71535683,85969,82.42,29123,44058,41911,80595,3744,209,682,739,2105,6452,14985,56214,8318,32190,3067,18616,10507,65000,317
NY ND,Columbia,New York,36021,-73.64411163,42.24362564,62982,98.72,23696,30956,32026,59889,2441,109,251,292,1021,4418,11023,37227,10314,29139,5443,16477,7219,103100,350
NY ND,Cortland,New York,36023,-76.0724411,42.60032654,48963,97.93,17247,23330,25633,48132,348,135,222,126,447,3475,8666,30869,5953,18681,1434,11103,6144,66200,321
NY ND,Delaware,New York,36025,-74.92604828,42.18772888,47225,32.8,17646,23228,23997,46307,476,116,184,142,536,3195,8685,27590,7755,27361,9715,13077,4569,67000,279
NY ND,Essex,New York,36031,-73.81290817,44.14182854,37152,20.57,13721,19071,18081,35682,1051,94,146,179,748,2557,6462,22656,5477,21493,7772,9892,3829,62200,294
NY ND,Franklin,New York,36033,-74.32378769,44.54435921,46540,28.34,16284,23993,22547,41897,1741,2348,127,427,1123,3215,8683,28639,6003,21962,5678,11226,5058,48900,253
NY ND,Fulton,New York,36035,-74.437397,43.13353539,54191,109.04,20995,26073,28118,53121,647,100,228,95,411,3628,10429,31167,8967,26260,5265,14999,5996,56000,256
NY ND,Greene,New York,36039,-74.15379715,42.27834511,44739,69.04,16596,22746,21993,41603,2170,133,184,649,1522,2918,7476,27225,7120,25000,8404,12093,4503,91700,336
NY ND,Hamilton,New York,36041,-74.46385193,43.66479301,5279,3.07,2153,2654,2625,5247,12,10,6,4,31,256,886,3236,901,8234,6081,1669,484,71800,253
NY ND,Herkimer,New York,36043,-74.95466614,43.45996666,65797,46.47,24936,31769,34028,65285,188,109,139,76,370,4502,12338,37888,11069,30799,5863,17795,7141,54400,250
NY ND,Jefferson,New York,36045,-75.90538788,44.0308075,110943,87.15,37851,56968,53975,101157,6501,436,959,1890,3136,9486,21030,68249,12178,50519,12668,22439,15412,59400,334
NY ND,Lewis,New York,36049,-75.48345184,43.81854439,26796,20.89,9253,13379,13417,26470,113,61,93,59,128,2244,5917,15401,3234,13182,3929,7057,2196,49800,275
NY ND,Madison,New York,36053,-75.61629486,42.9569931,69120,105.37,23567,33980,35140,67481,752,260,421,206,572,4882,12552,43751,7935,26641,3074,17515,6052,69300,322
NY ND,Montgomery,New York,36057,-74.42549896,42.90667534,51981,128.67,20185,24731,27250,50173,444,94,217,1053,2703,3599,9262,29020,10100,21851,1666,13381,6804,61600,245
NY ND,Oneida,New York,36065,-75.47546768,43.23961258,250836,205.77,92562,124145,126691,232461,13661,504,2175,2035,5804,17488,43268,151318,38762,101251,8689,60392,32170,72300,297
NY ND,Onondaga,New York,36067,-76.19390106,43.02476311,468973,598.18,177898,224552,244421,418533,37724,3259,6842,2615,7195,35006,79839,293288,60840,190878,12980,112990,64908,81000,376
NY ND,Oswego,New York,36075,-76.18959808,43.43198586,121771,127.64,42434,59820,61951,119910,619,429,477,336,1159,9483,24428,74746,13114,48548,6114,30978,11456,65100,311
NY ND,Otsego,New York,36077,-75.02405548,42.61213684,60517,60.28,21725,28864,31653,59111,810,116,316,164,720,3813,10224,37373,9107,26385,4660,15851,5874,67800,304
NY ND,Rensselaer,New York,36083,-73.52355576,42.7076416,154429,235.77,57612,75824,78605,146197,5170,277,2204,581,1864,10839,26003,97173,20414,62591,4979,36811,20801,93200,344
NY ND,Saratoga,New York,36091,-73.87011719,43.08123207,181276,223.8,66425,89512,91764,176903,2278,264,1388,443,1951,13409,33086,116062,18719,75105,8680,48042,18383,107500,418
NY ND,Schenectady,New York,36093,-74.06329727,42.83073616,149285,724.68,59181,71195,78090,139843,6348,261,1822,1011,2489,10440,23813,90321,24711,62769,3588,38903,20278,94000,365
NY ND,Schoharie,New York,36095,-74.43787766,42.59414673,31859,51.06,11257,15560,16299,31096,428,69,105,161,538,1994,5754,19594,4517,14431,3174,8342,2915,73600,299
NY ND,St. Lawrence,New York,36089,-75.19121552,44.52248001,111974,41.05,37964,56309,55665,108270,1621,830,805,448,1275,7442,20773,70239,13520,47521,9557,26135,11829,44100,261
NY ND,Tioga,New York,36107,-76.32010269,42.20370865,52337,100.84,18838,25809,26528,51498,314,95,313,117,367,4120,10705,31800,5712,20254,1416,14841,3997,72800,300
NY ND,Tompkins,New York,36109,-76.4709053,42.4475174,94097,197.27,33338,46685,47412,84874,3132,281,5144,666,2117,5293,12943,67396,8465,35338,2000,18427,14911,94700,426
NY ND,Ulster,New York,36111,-74.3541832,41.88015556,165304,146.16,60807,81915,83389,153130,8055,470,1969,1680,6832,11396,27213,105197,21498,71716,10909,42104,18703,114300,450
NY ND,Warren,New York,36113,-73.83193207,43.51344872,59209,67.13,22559,28511,30698,58452,301,110,270,76,476,4015,10733,35910,8551,31737,9178,15625,6934,91200,369
NY ND,Washington,New York,36115,-73.44174194,43.37123871,59330,70.97,20256,30464,28866,56705,2051,104,122,348,1313,4315,10993,36254,7768,24216,3960,14956,5300,70200,319
NY SD D,Bronx,New York,36005,-73.8519783,40.86495972,1203789,28661.64,424112,555154,648635,430077,449399,6069,35562,282682,523111,102913,228735,731921,140220,440955,16843,75842,348270,173900,392
NY SD D,Dutchess,New York,36027,-73.74202728,41.7596035,259462,322.71,89567,130484,128978,229194,21788,374,5826,2280,9765,18451,43515,167813,29683,97632,8065,61899,27668,149200,530
NY SD D,New York,New York,36061,-73.95380783,40.79491997,1487536,67615.27,716422,700573,786963,867227,326967,5728,110629,176985,386630,78590,168237,1043325,197384,785127,68705,128037,588385,487300,478
NY SD D,Orange,New York,36071,-74.35751724,41.3866787,307647,372.45,101506,154711,152936,273600,22223,824,3549,7451,21535,25627,59434,190502,32084,110814,9308,68470,33036,141700,513
NY SD D,Putnam,New York,36079,-73.75622177,41.42559624,83941,363.38,28094,41895,42046,81827,851,121,758,384,2246,6478,15155,54733,7575,31898,3804,22997,5097,195000,672
NY SD D,Rockland,New York,36087,-74.06715393,41.16157341,265475,1517,84874,128906,136569,222858,26468,654,10753,4742,17711,19048,49911,169645,26871,88264,3390,61216,23658,217100,633
NY SD D,Sullivan,New York,36105,-74.75973892,41.72562599,69277,70.98,24576,35549,33728,61248,5884,140,547,1458,4747,4967,12168,41956,10186,41814,17238,16882,7694,93400,390
NY SD D,Westchester,New York,36119,-73.72949219,41.12589645,874866,1997.41,320030,415280,459586,694308,120195,1405,32169,26789,86194,57718,132551,558571,126026,336727,16697,190933,129097,283500,543
NY WD,Allegany,New York,36003,-78.01375961,42.26329041,50470,48.91,17011,25044,25426,49670,305,103,304,88,313,3469,9530,30705,6766,21951,4940,12430,4581,37600,232
NY WD,Cattaraugus,New York,36009,-78.68253708,42.27186203,84234,64.5,30456,40825,43409,81091,757,1866,327,193,534,6332,16967,49105,11830,36839,6383,22286,8170,42100,227
NY WD,Chautauqua,New York,36013,-79.41054916,42.28754425,141895,133.36,53696,68438,73457,136311,2405,558,545,2076,4055,9810,26122,83667,22296,62682,8986,36817,16879,47800,251
NY WD,Chemung,New York,36015,-76.75015259,42.14754868,95195,231.62,35275,46240,48955,88370,5245,211,690,679,1441,6803,17335,56722,14335,37290,2015,24095,11180,53600,291
NY WD,Erie,New York,36029,-78.79839706,42.77111816,968532,925.94,376994,461204,507328,831903,109852,5600,10220,10957,22249,66512,158955,595982,147083,402131,25137,240179,136815,74000,292
NY WD,Genesee,New York,36037,-78.18331146,43.00242043,60060,121.33,21614,29229,30831,57937,1065,683,211,164,451,4532,11370,35944,8214,22596,982,15732,5882,65800,322
NY WD,Livingston,New York,36051,-77.76912308,42.73111343,62372,98.53,21197,30091,32281,59983,1513,188,323,365,975,4248,10945,40197,6982,23084,1887,15543,5654,72800,322
NY WD,Monroe,New York,36055,-77.67876053,43.15385818,713968,1076.87,271944,342764,371204,600328,85041,2020,12667,13912,26450,54587,120863,449389,89129,285524,13580,176927,95017,90700,418
NY WD,Niagara,New York,36063,-78.76368713,43.19711876,220756,419.69,84809,105755,115001,205308,12104,2011,806,527,2098,15685,39317,132302,33452,90385,5576,57723,27086,62700,288
NY WD,Ontario,New York,36069,-77.28816605,42.81195641,95101,147.67,34929,46654,48447,92273,1718,228,500,382,1266,6908,16883,58806,12504,38947,4018,25600,9329,78300,364
NY WD,Orleans,New York,36073,-78.22885513,43.25094032,41846,107.02,14428,20963,20883,38288,2754,194,147,463,1029,3092,8168,25328,5258,16345,1917,10731,3697,56900,291
NY WD,Schuyler,New York,36097,-76.86083603,42.39619446,18662,56.72,6818,9259,9403,18353,157,50,39,63,165,1328,3710,10965,2659,8472,1654,5272,1546,48500,265
NY WD,Seneca,New York,36099,-76.78010178,42.78881836,33683,103.01,12285,16572,17111,32731,538,84,215,115,363,2492,6218,19979,4994,14314,2029,9130,3155,57500,308
NY WD,Steuben,New York,36101,-77.35578156,42.29111099,99088,70.98,37299,48676,50412,97039,1153,205,551,140,518,7328,19639,57690,14431,43019,5720,27261,10038,46200,262
NY WD,Wayne,New York,36117,-77.03783798,43.17844772,89123,147.31,31977,43921,45202,85014,2793,240,341,735,1518,7193,17741,53881,10308,35188,3211,24528,7449,70700,316
NY WD,Wyoming,New York,36121,-78.21874237,42.70306778,42507,71.44,13897,22673,19834,39735,2065,89,127,491,1004,2972,8249,26152,5134,15848,1951,10443,3454,52500,266
NY WD,Yates,New York,36123,-77.12589645,42.61257172,22810,67.29,8419,11030,11780,22501,148,47,69,45,230,1683,4373,13259,3495,11629,3210,6437,1982,55500,262
OH ND,Allen,Ohio,39003,-84.13116455,40.77845764,109755,271,39408,54343,55412,96177,12313,202,572,491,1240,8288,21718,65060,14689,42758,3350,28246,11162,52100,264
OH ND,Ashland,Ohio,39005,-82.27560806,40.80981445,47507,112.04,17101,23201,24306,46686,460,49,271,41,191,3327,9662,27980,6538,18139,1038,12660,4441,53600,243
OH ND,Ashtabula,Ohio,39007,-80.76263046,41.74093246,99821,141.99,36760,48219,51602,95465,3138,196,350,672,1538,7314,20004,57835,14668,41214,4454,26429,10331,45800,243
OH ND,Auglaize,Ohio,39011,-84.16147232,40.51958084,44585,112.02,15976,21725,22860,44225,66,50,177,67,243,3564,9480,25532,6009,16907,931,12283,3693,58500,256
OH ND,Carroll,Ohio,39019,-81.08570862,40.57300377,26521,67.48,9667,13027,13494,26254,135,65,29,38,99,1851,5401,15648,3621,11536,1869,7585,2082,46600,205
OH ND,Columbiana,Ohio,39029,-80.80204391,40.75551796,108276,202.76,40775,52196,56080,106369,1409,174,219,105,405,7561,21244,63380,16091,44035,3260,30574,10201,42600,209
OH ND,Crawford,Ohio,39033,-82.91259384,40.84845734,47870,118.78,18383,23119,24751,47361,253,67,116,73,246,3424,9356,28151,6939,19514,1131,13079,5304,43100,205
OH ND,Cuyahoga,Ohio,39035,-81.66461563,41.45190048,1412140,3076.56,563243,663281,748859,1025756,350185,2533,18085,15581,31447,100293,237890,852891,221066,604538,41295,349057,214186,72100,321
OH ND,Defiance,Ohio,39039,-84.50648117,41.2940197,39350,95.05,14070,19400,19950,36962,493,80,121,1694,2673,2877,8402,23468,4603,14737,667,11028,3042,53300,252
OH ND,Erie,Ohio,39043,-82.62291336,41.36659431,76779,290.83,28932,37312,39467,69613,6312,150,265,439,1180,5406,14696,46226,10451,32827,3895,20633,8299,65100,286
OH ND,Fulton,Ohio,39051,-84.12657166,41.60028076,38498,94.59,13504,18819,19679,37097,93,62,137,1109,1842,2946,8379,22314,4859,14095,591,10601,2903,59700,263
OH ND,Geauga,Ohio,39055,-81.19058609,41.52793312,81129,198.85,26906,40131,40998,79629,1056,83,312,49,294,6373,16874,49253,8629,27922,1016,23066,3840,107700,368
OH ND,Hancock,Ohio,39063,-83.6449852,40.98849678,65536,123.19,24642,31739,33797,63572,591,91,401,881,1680,4872,12770,39402,8492,26107,1465,18274,6368,63300,286
OH ND,Hardin,Ohio,39065,-83.64675522,40.65509796,31111,66.05,11250,15246,15865,30661,236,66,115,33,145,2078,5908,18907,4218,11976,726,8068,3182,42100,201
OH ND,Henry,Ohio,39069,-84.10251236,41.32377434,29108,70.14,10401,14326,14782,27951,147,53,95,862,1332,2230,6222,16697,3959,11000,599,8156,2245,55200,238
OH ND,Holmes,Ohio,39075,-81.93026352,40.55712891,32849,77.47,9315,16163,16686,32706,52,24,43,24,123,3540,8233,17546,3530,10007,692,7191,2124,63400,219
OH ND,Huron,Ohio,39077,-82.58275604,41.13706398,56240,113.85,20239,27366,28874,54982,597,85,153,423,1006,4567,11895,33061,6717,21382,1143,14499,5740,56700,264
OH ND,Lake,Ohio,39085,-81.23918915,41.70721817,215499,932.9,80421,104625,110874,209879,3528,250,1447,395,1469,14901,38843,135966,25789,83194,2773,60931,19490,74200,406
OH ND,Lorain,Ohio,39093,-82.10521317,41.28700256,271126,547.73,96064,131915,139211,241549,21230,738,1479,6130,15261,20044,54372,165385,31325,99937,3873,69048,27016,66100,296
OH ND,Lucas,Ohio,39095,-83.74030106,41.57009697,462361,1355.9,177500,220583,241778,380155,68456,1164,4981,7605,15658,36103,86212,280116,59930,191388,13888,115364,62136,57300,297
OH ND,Mahoning,Ohio,39099,-80.80099869,41.01433945,264806,635.03,101136,125046,139760,221109,39681,444,985,2587,5946,17325,47594,154804,45083,107915,6779,72515,28621,47900,260
OH ND,Marion,Ohio,39101,-83.13853455,40.57235909,64274,159.49,23484,32039,32235,60948,2707,148,285,186,485,4800,12366,38974,8134,25149,1665,16651,6833,42500,235
OH ND,Medina,Ohio,39103,-81.92179108,41.12963676,122354,289.94,41792,60141,62213,120504,850,172,684,144,711,8939,25928,75627,11860,43330,1538,33129,8663,83700,357
OH ND,Mercer,Ohio,39107,-84.61067581,40.54081345,39443,86.31,13398,19670,19773,39131,14,85,100,113,280,3439,8801,21892,5311,14969,1571,10694,2704,61100,235
OH ND,Ottawa,Ohio,39123,-83.0969162,41.5404129,40029,158.22,15170,19585,20444,39029,265,51,94,590,1491,2468,7472,23879,6210,23340,8170,11884,3286,68600,282
OH ND,Paulding,Ohio,39125,-84.56196976,41.11952019,20488,48.9,7252,10075,10413,19920,236,54,20,258,628,1577,4535,11932,2444,7951,699,6037,1215,42500,201
OH ND,Portage,Ohio,39133,-81.19080734,41.16510582,142585,289.22,49229,69474,73111,136998,3906,292,1191,198,798,9375,25598,94271,13341,52299,3070,34505,14724,69200,331
OH ND,Putnam,Ohio,39137,-84.12919998,41.00913429,33819,69.87,11082,16844,16975,33197,26,44,25,527,1418,2953,7757,18980,4129,11600,518,9346,1736,58000,222
OH ND,Richland,Ohio,39139,-82.52895355,40.7708168,126137,253.8,47573,61801,64336,115078,9981,223,578,277,903,8756,24205,76799,16377,50350,2777,33687,13886,52200,260
OH ND,Sandusky,Ohio,39143,-83.12454224,41.3732338,61963,151.5,22464,30356,31607,58282,1553,94,142,1892,3544,4537,12824,36305,8297,23753,1289,16730,5734,57200,266
OH ND,Seneca,Ohio,39147,-83.12276077,41.12029266,59733,108.02,21277,29084,30649,57474,1172,90,234,763,1676,4281,12736,34744,7972,22473,1196,15735,5542,47700,225
OH ND,Stark,Ohio,39151,-81.36035919,40.80824852,367585,640.39,139573,175912,191673,339421,25052,950,1529,633,2755,25230,67236,222148,52971,146910,7337,97872,41701,57700,272
OH ND,Summit,Ohio,39153,-81.52845383,41.12747574,514990,1249.98,199998,246590,268400,446902,61185,1065,4989,849,3017,36096,89693,317987,71214,211477,11479,137444,62554,61900,311
OH ND,Trumbull,Ohio,39155,-80.76345825,41.31255722,227813,372.24,86056,109233,118580,210915,15221,341,973,363,1454,15350,42047,137556,32860,90533,4477,62899,23157,53300,269
OH ND,Tuscarawas,Ohio,39157,-81.48580551,40.43486023,84090,147.53,31971,40236,43854,83107,623,138,187,35,228,5910,16242,49414,12524,33982,2011,23990,7981,49900,236
OH ND,Van Wert,Ohio,39161,-84.56137466,40.83716011,30464,74.3,11266,14817,15647,29900,193,31,78,262,482,2204,6230,17473,4557,11998,732,9077,2189,46000,228
OH ND,Wayne,Ohio,39169,-81.88301468,40.82825279,101461,182.16,35619,49702,51759,99131,1557,130,535,108,429,7980,20819,60859,11803,37036,1417,25350,10269,65700,283
OH ND,Williams,Ohio,39171,-84.5619278,41.56645012,36956,87.57,13807,18147,18809,36366,23,46,127,394,826,2768,7692,21433,5063,14745,938,10637,3170,48200,245
OH ND,Wood,Ohio,39173,-83.63913345,41.39005852,113269,182.99,39677,54374,58895,109303,1168,197,1028,1573,2882,7258,20319,74224,11468,41760,2083,27752,11925,72200,320
OH ND,Wyandot,Ohio,39175,-83.30657578,40.8363533,22254,54.81,8168,10703,11551,22087,20,20,65,62,162,1610,4513,12869,3262,8596,428,6184,1984,46600,213
OH SD,Adams,Ohio,39001,-83.49114227,38.82448578,25371,43.3,9192,12452,12919,25212,47,67,30,15,90,1842,5516,14578,3435,10237,1045,6725,2467,36900,176
OH SD,Athens,Ohio,39009,-82.00932312,39.36489677,59549,117.22,20139,29216,30333,56163,1678,167,1374,167,438,3196,8935,41575,5843,21737,1598,12478,7661,47600,285
OH SD,Belmont,Ohio,39013,-80.96832657,40.00180435,71074,132.35,28161,33406,37668,69520,1308,81,129,36,194,4193,12653,40902,13326,30575,2414,20774,7387,42100,195
OH SD,Brown,Ohio,39015,-83.86296082,38.94137001,34966,70.92,12379,17161,17805,34487,406,28,30,15,49,2623,7389,20484,4470,13720,1341,9404,2975,49200,212
OH SD,Butler,Ohio,39017,-84.57064056,39.43872643,291479,620.17,104535,141045,150434,274892,13134,379,2659,415,1467,21425,54856,185485,29713,110353,5818,72365,32170,73000,325
OH SD,Champaign,Ohio,39021,-83.76095963,40.13929367,36019,83.96,13253,17728,18291,34698,992,68,113,148,246,2463,7108,21825,4623,14030,777,9795,3458,55400,248
OH SD,Clark,Ohio,39023,-83.78046036,39.90135956,147548,370.72,55198,70705,76843,133242,13031,294,653,328,970,10253,27671,89179,20445,58377,3179,38168,17030,54900,256
OH SD,Clermont,Ohio,39025,-84.14864731,39.01398468,150187,329.36,52726,73621,76566,148084,1291,218,453,141,721,12250,31796,93090,13051,55315,2589,38028,14698,71200,340
OH SD,Clinton,Ohio,39027,-83.79047394,39.39229965,35415,86.38,13038,17209,18206,34471,716,59,138,31,122,2554,7124,21119,4618,13740,702,8823,4215,52200,261
OH SD,Coshocton,Ohio,39031,-81.89952087,40.29912186,35427,62.59,13433,17117,18310,34819,415,68,112,13,106,2555,7124,20644,5104,14964,1531,10171,3262,44500,208
OH SD,Darke,Ohio,39037,-84.61298752,40.13506126,53619,89.37,19459,25961,27658,53067,184,96,114,158,343,3872,10934,30930,7883,20338,879,14865,4594,52300,230
OH SD,Delaware,Ohio,39041,-82.99394989,40.2846489,66929,151.08,23116,33110,33819,64888,1424,104,385,128,336,4946,13460,42397,6126,24377,1261,18050,5066,95900,330
OH SD,Fairfield,Ohio,39045,-82.60490799,39.74032402,103461,204.47,36813,51316,52145,101610,1153,193,378,127,489,7116,20878,63809,11658,39014,2201,27493,9320,68900,284
OH SD,Fayette,Ohio,39047,-83.46237564,39.54166985,27466,67.82,10221,13327,14139,26593,662,50,102,59,89,1892,5353,16158,4063,10816,595,6634,3587,43800,214
OH SD,Franklin,Ohio,39049,-83.01000595,39.96332741,961437,1770.6,378723,463642,497795,783714,152840,2056,19437,3390,9236,73529,163237,632009,92662,405418,26695,207833,170890,73800,355
OH SD,Gallia,Ohio,39053,-82.33601379,38.80725288,30954,65.72,11367,15131,15823,29831,871,79,136,37,156,2111,6155,18713,3975,12564,1197,8385,2982,48400,208
OH SD,Greene,Ohio,39057,-83.87695313,39.70056534,136731,328.68,48351,66940,69791,124081,9611,398,2133,508,1379,9107,26021,88301,13302,50238,1887,33567,14784,78200,352
OH SD,Guernsey,Ohio,39059,-81.47422409,40.02347946,39024,74.76,14894,18602,20422,38166,616,70,141,31,130,2722,7755,22719,5828,17262,2368,10870,4024,38600,211
OH SD,Hamilton,Ohio,39061,-84.53518677,39.16275597,866228,2102.5,338881,409895,456333,672972,181145,1204,9198,1709,5198,67593,157337,525872,115426,361421,22540,197551,141330,72200,304
OH SD,Harrison,Ohio,39067,-81.09522629,40.29229355,16085,40.21,6111,7762,8323,15645,393,22,15,10,43,931,3136,9228,2790,7301,1190,4628,1483,33300,180
OH SD,Highland,Ohio,39071,-83.60630035,39.19631386,35728,64.61,13230,17350,18378,34876,692,73,71,16,108,2601,7191,20579,5357,14842,1612,9649,3581,42200,199
OH SD,Hocking,Ohio,39073,-82.45019531,39.50473595,25533,60.36,9351,12772,12761,25199,234,55,25,20,93,1788,5005,15340,3400,10481,1130,7087,2264,43400,219
OH SD,Jackson,Ohio,39079,-82.61705017,39.02009201,30230,71.98,11260,14408,15822,29895,218,53,39,25,89,2111,6192,17695,4232,12452,1192,8261,2999,39400,192
OH SD,Jefferson,Ohio,39081,-80.77113724,40.37480164,80298,195.85,31311,37974,42324,75270,4488,167,266,107,426,4575,14372,47542,13809,33911,2600,23029,8282,42900,191
OH SD,Knox,Ohio,39083,-82.45911407,40.40276718,47473,89.74,17230,22883,24590,46747,381,93,195,57,171,3015,8821,28643,6994,18508,1278,12440,4790,49100,235
OH SD,Lawrence,Ohio,39087,-82.55860138,38.62235641,61834,135.3,22899,29415,32419,60115,1559,57,75,28,139,4114,12593,36909,8218,24788,1889,16528,6371,43700,210
OH SD,Licking,Ohio,39089,-82.47901154,40.09169769,128300,187.03,47254,62110,66190,125181,2217,247,475,180,604,9223,24547,79358,15172,50032,2778,34019,13235,61600,271
OH SD,Logan,Ohio,39091,-83.762146,40.37807846,42310,92.38,15952,20490,21820,41156,804,58,240,52,159,3118,8564,24522,6106,19473,3521,11689,4263,53000,249
OH SD,Madison,Ohio,39097,-83.43061447,39.90248299,37068,79.37,11990,20086,16982,33947,2764,96,157,104,216,2539,6643,24151,3735,12621,631,8422,3568,62300,254
OH SD,Meigs,Ohio,39105,-82.03411865,39.03683472,22987,53.21,8662,11122,11865,22734,177,44,20,12,59,1524,4658,13355,3450,9795,1133,6814,1848,35700,174
OH SD,Miami,Ohio,39109,-84.22229385,40.03793144,93182,227.27,34559,45306,47876,90519,1779,158,606,120,366,6555,18437,56448,11742,35985,1426,25134,9425,65000,291
OH SD,Monroe,Ohio,39111,-81.06838989,39.69933701,15497,33.91,5754,7614,7883,15437,19,26,12,3,24,962,3025,9090,2420,6567,813,4598,1156,39600,166
OH SD,Montgomery,Ohio,39113,-84.2664566,39.75048637,573809,1252.86,226192,274869,298940,463551,101817,1065,5886,1490,4539,42232,100408,359161,72008,240820,14628,142371,83821,65000,316
OH SD,Morgan,Ohio,39115,-81.8319397,39.61123276,14194,33.8,5170,6885,7309,13524,570,64,12,24,36,1017,3053,7991,2133,6681,1511,3990,1180,39900,190
OH SD,Morrow,Ohio,39117,-82.81918716,40.52812004,27749,68.35,9656,13770,13979,27579,64,49,38,19,92,2039,6023,16628,3059,10312,656,7820,1836,47600,217
OH SD,Muskingum,Ohio,39119,-81.95763397,39.95628548,82068,125.49,30753,39073,42995,78125,3468,214,152,109,247,5878,16043,48794,11353,33029,2276,22456,8297,47100,229
OH SD,Noble,Ohio,39121,-81.46342468,39.76398659,11336,28.41,4137,5543,5793,11301,7,15,9,4,23,853,2429,6350,1704,4998,861,3309,828,37200,187
OH SD,Perry,Ohio,39127,-82.24477386,39.73843384,31557,76.59,11264,15403,16154,31408,57,46,21,25,81,2354,6794,18328,4081,12260,996,8792,2472,36900,207
OH SD,Pickaway,Ohio,39129,-82.99759674,39.63070297,48255,95.93,15602,26466,21789,44867,3036,127,95,130,323,3196,8517,31744,4798,16385,783,11181,4421,62200,263
OH SD,Pike,Ohio,39131,-83.08409119,39.06861877,24249,54.74,8805,11804,12445,23807,327,72,41,2,74,1735,5230,13994,3290,9722,917,6113,2692,42300,210
OH SD,Preble,Ohio,39135,-84.64317322,39.7413559,40113,94.16,14347,19783,20330,39819,147,53,65,29,105,2844,8222,24119,4928,15174,827,11068,3279,52700,231
OH SD,Ross,Ohio,39141,-83.06662369,39.33602715,69330,100.19,24325,36091,33239,64362,4467,155,266,80,346,4421,12912,43427,8570,26173,1848,17154,7171,49200,223
OH SD,Scioto,Ohio,39145,-82.96024704,38.79252434,80327,131.04,29786,38960,41367,77253,2458,409,126,81,261,5323,16177,46885,11942,32408,2622,20774,9012,37100,199
OH SD,Shelby,Ohio,39149,-84.21483612,40.32969093,44915,109.82,15626,22399,22516,43789,615,49,393,69,185,3606,9837,26249,5223,16509,883,11608,4018,59900,260
OH SD,Union,Ohio,39159,-83.35710526,40.30472946,31969,73.16,11037,14899,17070,30563,1168,57,132,49,159,2322,6211,19888,3548,11599,562,8208,2829,67400,286
OH SD,Vinton,Ohio,39163,-82.50916672,39.20849037,11098,26.81,4069,5447,5651,11071,4,16,3,4,33,787,2290,6496,1525,4856,787,3272,797,34900,176
OH SD,Warren,Ohio,39165,-84.16877365,39.42030907,113909,282.65,39150,57503,56406,110526,2415,231,627,110,524,8789,21867,72935,10318,40636,1486,29252,9898,77600,340
OH SD,Washington,Ohio,39167,-81.44515991,39.42619705,62254,97.27,23636,30004,32250,61129,774,111,185,55,225,4040,11928,37784,8502,25752,2116,17614,6022,51900,227
OK ED,Adair,Oklahoma,40001,-94.63785553,35.90602303,18421,31.93,6386,9043,9378,10235,4,8065,12,105,245,1437,4214,10278,2492,7124,738,4660,1726,30200,143
OK ED,Atoka,Oklahoma,40005,-96.03684998,34.4262104,12778,13.04,4495,6710,6068,10365,760,1587,16,50,118,802,2514,7495,1967,5110,615,3373,1122,30300,150
OK ED,Bryan,Oklahoma,40013,-96.18920898,33.93385887,32089,35.58,12524,15395,16694,26790,422,4557,143,177,465,2143,5931,18547,5468,14875,2351,8725,3799,36000,189
OK ED,Carter,Oklahoma,40019,-97.24270248,34.2931881,42919,51.83,16601,20555,22364,35199,3580,3632,164,344,781,3018,8703,24115,7083,19201,2600,12011,4590,38100,214
OK ED,Cherokee,Oklahoma,40021,-95.0422554,35.90857124,34049,45.52,12657,16511,17538,22068,384,11380,68,149,470,2456,6775,20138,4680,15935,3278,8626,4031,43300,221
OK ED,Choctaw,Oklahoma,40023,-95.57547379,34.01538658,15302,20.08,5952,7264,8038,10933,1958,2319,25,67,195,1109,3199,8145,2849,6844,892,4303,1649,30900,126
OK ED,Coal,Oklahoma,40029,-96.30077362,34.59934235,5780,11.12,2279,2769,3011,4757,48,955,2,18,39,360,1177,3159,1084,2725,446,1680,599,25100,131
OK ED,Haskell,Oklahoma,40061,-95.1307106,35.26711082,10940,19.19,4319,5287,5653,9216,98,1592,8,26,74,672,2168,6033,2067,5138,819,3370,949,31300,153
OK ED,Hughes,Oklahoma,40063,-96.23357773,35.03313446,13023,16.16,5224,6121,6902,10354,384,2232,13,40,136,732,2467,6873,2951,6021,797,4030,1194,21000,135
OK ED,Johnston,Oklahoma,40069,-96.6660614,34.31879425,10032,15.7,3783,4887,5145,8173,215,1583,14,47,120,622,2057,5606,1747,4478,695,2766,1017,28600,154
OK ED,Latimer,Oklahoma,40077,-95.21950912,34.87623405,10333,14.19,3693,5146,5187,8524,154,1574,20,61,115,694,2102,5748,1789,4303,610,2766,927,33900,173
OK ED,Le Flore,Oklahoma,40079,-94.7416687,34.95439148,43270,27.3,15938,21232,22038,36907,1030,5112,94,127,419,3054,8870,24804,6542,18029,2091,12001,3937,34900,182
OK ED,Love,Oklahoma,40085,-97.24268341,33.90041542,8157,15.72,2992,4181,3976,6992,360,559,12,234,335,483,1564,4768,1342,3583,591,2355,637,35900,189
OK ED,Marshall,Oklahoma,40095,-96.75869751,34.00763893,10829,29.11,4350,5201,5628,9412,186,1088,13,130,275,626,1833,5890,2480,7389,3039,3413,937,37000,181
OK ED,McCurtain,Oklahoma,40089,-94.80533218,34.065588,33433,18.31,12234,16015,17418,24821,3452,4873,89,198,459,2563,7331,18809,4730,13828,1594,8940,3294,29200,146
OK ED,McIntosh,Oklahoma,40091,-95.65847778,35.3560791,16779,28.01,6786,8090,8689,12757,885,3072,27,38,150,938,2980,9240,3621,10708,3922,5277,1509,38700,159
OK ED,Murray,Oklahoma,40099,-97.08576202,34.49137497,12042,28.67,4651,5870,6172,10421,207,1331,16,67,169,717,2350,6654,2321,5742,1091,3373,1278,33700,177
OK ED,Muskogee,Oklahoma,40101,-95.41627121,35.56748199,68078,83.53,25174,32601,35477,48865,9527,9049,258,379,873,4753,13868,38705,10752,28882,3708,17599,7575,40900,217
OK ED,Okfuskee,Oklahoma,40107,-96.29828644,35.47052956,11551,18.39,4164,5864,5687,7833,1332,2333,17,36,140,746,2278,6468,2059,4894,730,3184,980,25700,135
OK ED,Okmulgee,Oklahoma,40111,-95.94579697,35.62287712,36490,52.28,14044,17613,18877,27372,4422,4454,80,162,458,2603,7163,20425,6299,16431,2387,10202,3842,30900,173
OK ED,Pittsburg,Oklahoma,40121,-95.71920395,34.95422554,40581,32.44,15911,19899,20682,33765,1505,5005,111,195,479,2405,7659,23132,7385,19433,3522,12000,3911,34700,191
OK ED,Pontotoc,Oklahoma,40123,-96.66430664,34.74141693,34119,47.59,13310,16137,17982,28246,862,4741,113,157,411,2190,6341,19870,5718,15094,1784,9190,4120,39900,201
OK ED,Pushmataha,Oklahoma,40127,-95.36006165,34.42385292,10997,7.76,4370,5401,5596,9164,112,1669,9,43,136,690,2114,6121,2072,5190,820,3346,1024,27700,127
OK ED,Seminole,Oklahoma,40133,-96.60729599,35.16205406,25412,39.77,9665,12092,13320,19033,1936,4304,40,99,340,1654,5111,13918,4729,11404,1739,7058,2607,27300,163
OK ED,Sequoyah,Oklahoma,40135,-94.778759,35.46442032,33828,49.89,12335,16496,17332,25887,791,7000,75,75,299,2461,7167,19747,4453,14314,1979,9105,3230,37800,196
OK ED,Wagoner,Oklahoma,40145,-95.51461029,35.97305107,47883,85.66,16946,23591,24292,41117,1984,4389,174,219,638,3440,10789,28990,4664,19262,2316,13384,3562,58300,244
OK ND,Craig,Oklahoma,40035,-95.21627426,36.75954437,14104,18.48,5272,6870,7234,10864,483,2695,34,28,101,835,2466,8319,2484,6041,769,3978,1294,33000,180
OK ND,Creek,Oklahoma,40037,-96.3259201,35.90738297,60915,65.5,22470,29609,31306,53522,1918,5128,142,205,660,4432,12661,35904,7918,25143,2673,17440,5030,44500,223
OK ND,Delaware,Oklahoma,40041,-94.7842865,36.4214325,28070,38.99,11003,13655,14415,20848,20,7096,43,63,227,1742,5064,15627,5637,16808,5805,8707,2296,44500,194
OK ND,Mayes,Oklahoma,40097,-95.22696686,36.29950523,33366,51.81,12672,16359,17007,27119,68,6020,74,85,308,2339,6738,19079,5210,15470,2798,9735,2937,42400,219
OK ND,Nowata,Oklahoma,40105,-95.6121788,36.8019371,9992,18.5,3994,4874,5118,7973,364,1634,6,15,73,626,1894,5551,1921,4534,540,3119,875,27900,155
OK ND,Osage,Oklahoma,40113,-96.5368576,36.58625984,41645,18.39,15383,20709,20936,30994,4210,6161,83,197,660,2913,8636,24400,5696,18196,2813,12095,3288,43300,168
OK ND,Ottawa,Oklahoma,40115,-94.83038712,36.83559036,30561,65.72,12124,14478,16083,24495,188,5568,102,208,375,1904,5428,17572,5657,14064,1940,8965,3159,30200,179
OK ND,Pawnee,Oklahoma,40117,-96.6394577,36.36545944,15575,28.27,6006,7713,7862,13770,119,1631,25,30,113,1063,3135,8853,2524,7407,1401,4746,1260,39200,195
OK ND,Rogers,Oklahoma,40131,-95.5741272,36.34121704,55170,80.78,19866,27231,27939,47242,456,7117,188,167,618,4046,11626,33883,5615,21455,1589,15764,4102,63700,268
OK ND,Tulsa,Oklahoma,40143,-96.03026581,36.14624977,503341,879.97,202537,242405,260936,417737,49618,25401,5976,4609,11958,38835,92659,313620,58227,227834,25297,122944,79593,60700,296
OK ND,Washington,Oklahoma,40147,-95.89564133,36.71570396,48066,113.63,19242,22995,25071,42324,1276,3783,411,272,788,3255,9170,27852,7789,21707,2465,14330,4912,51900,263
OK WD,Alfalfa,Oklahoma,40003,-98.31970978,36.73151016,6416,7.43,2469,3376,3040,5971,203,165,6,71,102,333,1019,3602,1462,3357,888,2003,466,23900,143
OK WD,Beaver,Oklahoma,40007,-100.4778786,36.74362755,6023,3.33,2327,2966,3057,5741,1,62,3,216,300,374,1296,3337,1016,2923,596,1809,518,47800,214
OK WD,Beckham,Oklahoma,40009,-99.67758179,35.2682209,18812,20.81,7351,9001,9811,17565,382,351,43,471,788,1384,3903,10154,3371,9117,1766,5134,2217,31200,178
OK WD,Blaine,Oklahoma,40011,-98.4178009,35.86189461,11470,12.47,4418,5502,5968,9778,499,995,20,178,287,831,2338,6089,2212,5729,1311,3362,1056,34000,160
OK WD,Caddo,Oklahoma,40015,-98.35375214,35.20619965,29550,22.98,10879,14314,15236,21270,750,6667,68,795,1430,2225,6215,16203,4907,13191,2312,7902,2977,31400,158
OK WD,Canadian,Oklahoma,40017,-97.98817444,35.52960968,74409,82.58,25597,37248,37161,67453,1816,3152,1226,762,1921,5752,16708,45776,6173,28560,2963,19589,6008,58100,296
OK WD,Cimarron,Oklahoma,40025,-102.5106468,36.74435616,3301,1.79,1300,1639,1662,3057,0,32,12,200,412,222,688,1759,632,1690,390,968,332,29000,138
OK WD,Cleveland,Oklahoma,40027,-97.40472031,35.1618576,174253,329.4,63991,87684,86569,154153,5271,8959,4012,1858,4655,12404,33575,116566,11708,71038,7047,40377,23614,61800,303
OK WD,Comanche,Oklahoma,40031,-98.45724106,34.63382912,111486,103.61,37569,57895,53591,79666,19908,5153,3065,3694,6923,9456,22059,70364,9607,43589,6020,22601,14968,54000,299
OK WD,Cotton,Oklahoma,40033,-98.39713287,34.28163338,6651,10.14,2609,3144,3507,5813,142,523,6,167,231,409,1290,3623,1329,3152,543,2010,599,32800,161
OK WD,Custer,Oklahoma,40039,-98.99688339,35.64099884,26897,27.42,9918,13131,13766,22896,930,1660,169,1242,1625,1924,5191,16194,3588,11636,1718,6293,3625,46900,219
OK WD,Dewey,Oklahoma,40043,-99.00816727,35.99022675,5551,5.51,2221,2685,2866,5182,5,315,6,43,73,351,1112,2883,1205,2733,512,1796,425,27900,133
OK WD,Ellis,Oklahoma,40045,-99.69343567,36.22215462,4497,3.65,1826,2193,2304,4351,3,66,11,66,138,246,932,2292,1027,2449,623,1467,359,29800,172
OK WD,Garfield,Oklahoma,40047,-97.77864838,36.3813839,56735,53.52,22460,27245,29490,52403,2020,1234,587,491,1086,3905,10973,33111,8746,26502,4042,15522,6938,38000,240
OK WD,Garvin,Oklahoma,40049,-97.29801941,34.69023323,26605,32.72,10417,12647,13958,23780,726,1882,59,158,331,1622,5141,14560,5282,11932,1515,7752,2665,32800,187
OK WD,Grady,Oklahoma,40051,-97.87989426,35.03090668,41747,37.75,15544,20087,21660,37602,1537,2152,121,335,728,2969,8847,24273,5658,17788,2244,11785,3759,42000,218
OK WD,Grant,Oklahoma,40053,-97.78338242,36.79497719,5689,5.67,2327,2703,2986,5564,3,72,14,36,58,388,1044,2962,1295,2955,628,1867,460,26100,165
OK WD,Greer,Oklahoma,40055,-99.56485748,34.91986084,6559,10.28,2551,3424,3135,5710,452,144,16,237,336,328,984,3647,1600,3126,575,1928,623,21800,137
OK WD,Harmon,Oklahoma,40057,-99.82860565,34.76638794,3793,7.06,1486,1809,1984,2854,288,38,6,607,656,258,783,1846,906,1793,307,1118,368,22800,102
OK WD,Harper,Oklahoma,40059,-99.64566803,36.79465675,4063,3.91,1645,2000,2063,3972,3,30,6,52,72,227,805,2189,842,2077,432,1300,345,29100,166
OK WD,Jackson,Oklahoma,40065,-99.43733597,34.59403038,28764,35.21,10455,14253,14511,23060,2696,510,392,2106,3325,2611,5867,16808,3478,12125,1670,6353,4102,43800,278
OK WD,Jefferson,Oklahoma,40067,-97.83050919,34.07450867,7010,9.12,2843,3331,3679,6340,40,342,18,270,310,414,1318,3743,1535,3522,679,2087,756,22800,117
OK WD,Kay,Oklahoma,40071,-97.10673523,36.79659843,48056,52.18,19083,23162,24894,42978,856,3650,240,332,851,3406,9347,26911,8392,22456,3373,13914,5169,42600,230
OK WD,Kingfisher,Oklahoma,40073,-97.93976974,35.94939423,13212,14.58,4932,6409,6803,12201,305,358,14,334,407,945,2839,7331,2097,5791,859,3905,1027,47900,213
OK WD,Kiowa,Oklahoma,40075,-99.00742722,34.85643005,11347,11.14,4551,5340,6007,9526,615,757,37,412,604,779,2246,5785,2537,5645,1094,3377,1174,27000,143
OK WD,Lincoln,Oklahoma,40081,-96.87811661,35.70809364,29216,30.31,10839,14324,14892,26392,789,1849,56,130,307,1981,6238,16637,4360,12302,1463,8728,2111,35100,194
OK WD,Logan,Oklahoma,40083,-97.40887833,35.9467144,29011,38.78,10180,14189,14822,23636,4029,935,98,313,556,1958,5932,17247,3874,12277,2097,7878,2302,46200,196
OK WD,Major,Oklahoma,40093,-98.52927399,36.33479881,8055,8.41,3121,3908,4147,7834,3,137,10,71,132,507,1667,4328,1553,3855,734,2522,599,37700,165
OK WD,McClain,Oklahoma,40087,-97.53631383,35.09868622,22795,39.17,8332,11364,11431,20759,233,1513,36,254,578,1466,4840,13732,2757,9300,968,6682,1650,46500,229
OK WD,Noble,Oklahoma,40103,-97.17190933,36.38498688,11045,15.01,4225,5365,5680,9828,200,935,24,58,126,773,2212,6265,1795,4894,669,3169,1056,33500,176
OK WD,Oklahoma,Oklahoma,40109,-97.40399933,35.55430412,599611,846.91,237879,288077,311534,461657,88407,24313,12033,13201,25452,45788,110902,370379,72542,279340,41461,145847,92032,53300,285
OK WD,Payne,Oklahoma,40119,-96.98633194,36.1008625,61507,89.01,23834,30740,30767,54991,1782,2652,1750,332,917,3577,9420,41780,6730,27381,3547,13001,10833,50700,295
OK WD,Pottawatomie,Oklahoma,40125,-96.87863922,35.18914604,58760,75.04,21796,28080,30680,49931,1326,6848,337,318,990,3950,11902,34452,8456,24528,2732,16105,5691,42400,230
OK WD,Roger Mills,Oklahoma,40129,-99.67921829,35.71949959,4147,3.62,1586,2045,2102,3948,3,167,4,25,73,265,888,2237,757,2048,462,1254,332,25900,118
OK WD,Stephens,Oklahoma,40137,-97.85096741,34.49008942,42299,47.85,16764,20166,22133,38829,945,1720,158,647,943,2702,8291,23611,7695,19675,2911,12526,4238,39000,204
OK WD,Texas,Oklahoma,40139,-101.4921761,36.74273109,16419,8.05,6214,8148,8271,15131,71,186,39,992,1634,1134,3488,9661,2136,7328,1114,4449,1765,44500,218
OK WD,Tillman,Oklahoma,40141,-98.91933823,34.38457298,10384,11.49,3933,4976,5408,7857,1043,348,28,1108,1461,722,2173,5378,2111,4704,771,2950,983,22700,153
OK WD,Washita,Oklahoma,40149,-98.98577881,35.28556824,11441,11.37,4421,5524,5917,10948,20,260,28,185,406,768,2321,6088,2264,6101,1680,3384,1037,28400,181
OK WD,Woods,Oklahoma,40151,-98.98250198,36.69560814,9103,7.05,3803,4359,4744,8811,49,134,28,81,141,508,1455,5104,2036,4782,979,2777,1026,32700,173
OK WD,Woodward,Oklahoma,40153,-99.27513885,36.48495102,18976,15.28,7087,9497,9479,17980,132,465,80,319,575,1303,4033,11120,2520,8512,1425,5137,1950,40300,210
OR D,Baker,Oregon,41001,-117.6512985,44.66119385,15317,4.99,6118,7633,7684,15024,30,147,52,64,276,1024,2990,8417,2886,7525,1407,4210,1908,42100,209
OR D,Benton,Oregon,41003,-123.445755,44.49134064,70811,104.29,26126,35818,34993,65116,606,553,3891,645,1735,4355,11415,48212,6829,27024,898,14392,11734,72900,330
OR D,Clackamas,Oregon,41005,-122.2633209,45.16542053,278850,149.12,103530,136996,141854,268479,1134,1971,4827,2439,7129,19394,55009,172458,31989,109003,5473,74207,29323,85100,404
OR D,Clatsop,Oregon,41007,-123.6774826,46.00232315,33301,41.37,13374,16534,16767,32118,114,373,443,253,648,2298,6262,19337,5404,17367,3993,8459,4915,62500,288
OR D,Columbia,Oregon,41009,-123.0626984,45.94897461,37557,57.69,13910,18787,18770,36539,42,511,284,181,684,2793,8003,22041,4720,14576,666,10314,3596,62800,280
OR D,Coos,Oregon,41011,-124.0955238,43.13895416,60273,37.53,24134,29754,30519,57787,144,1401,577,364,1353,3852,11283,34722,10416,26668,2534,16041,8093,49800,265
OR D,Crook,Oregon,41013,-120.3798256,44.12400818,14111,4.73,5455,7074,7037,13637,11,221,47,195,388,1024,2840,8003,2244,6066,611,3897,1558,50300,263
OR D,Curry,Oregon,41015,-124.1433983,42.47436905,19327,11.86,8311,9550,9777,18626,31,462,122,86,354,1084,2906,10614,4723,9885,1574,6026,2285,83400,316
OR D,Deschutes,Oregon,41017,-121.4034892,43.99617195,74958,24.78,29217,37334,37624,73343,85,648,444,438,1526,5185,14140,45235,10398,35928,6711,20734,8483,74500,364
OR D,Douglas,Oregon,41019,-123.1043015,43.31825638,94649,18.76,35872,46870,47779,91718,143,1479,673,636,2225,6691,18769,54626,14563,38298,2426,24709,11163,56000,281
OR D,Gilliam,Oregon,41021,-120.2060356,45.43492508,1717,1.42,696,856,861,1693,0,10,9,5,30,114,347,924,332,932,236,464,232,31600,221
OR D,Grant,Oregon,41023,-118.9477577,44.47164536,7853,1.74,3092,3950,3903,7691,6,87,16,53,152,540,1589,4584,1140,3774,682,2189,903,46900,240
OR D,Harney,Oregon,41025,-119.0594826,43.01524544,7060,0.69,2760,3554,3506,6695,2,259,40,64,221,541,1432,4104,983,3305,545,1940,820,37800,205
OR D,Hood River,Oregon,41027,-121.6823082,45.48579788,16903,32.44,6425,8614,8289,15346,46,201,305,1005,2752,1293,3327,9918,2365,7569,1144,3990,2435,77200,316
OR D,Jackson,Oregon,41029,-122.753727,42.49720764,146389,52.53,57238,71481,74908,140188,340,1863,1429,2569,5949,9758,26947,85972,23712,60376,3138,37920,19318,74900,346
OR D,Jefferson,Oregon,41031,-121.1128388,44.60160255,13676,7.64,4744,6870,6806,10144,24,2674,62,772,1448,1393,2889,7693,1701,6311,1567,3077,1667,53700,264
OR D,Josephine,Oregon,41033,-123.6398125,42.38277817,62649,38.2,25081,30458,32191,60764,127,874,460,424,1749,3965,11231,34618,12835,26912,1831,17668,7413,74700,319
OR D,Klamath,Oregon,41035,-121.5772018,42.79912567,57702,9.69,22341,29079,28623,53191,381,2370,461,1299,2984,4098,11271,34100,8233,25954,3613,14562,7779,52700,260
OR D,Lake,Oregon,41037,-120.3484688,42.79912567,7186,0.87,2765,3611,3575,6825,5,198,46,112,270,534,1488,4131,1033,3434,669,1876,889,41900,238
OR D,Lane,Oregon,41039,-122.9605255,43.85770416,282912,62.01,110799,137789,145123,269798,2107,3207,5557,2243,6852,18844,50356,176634,37078,116676,5877,67387,43412,65800,360
OR D,Lincoln,Oregon,41041,-123.8552856,44.65206337,38889,39.68,16455,18746,20143,37380,68,952,346,143,598,2368,6712,22009,7800,22389,5934,10864,5591,69400,317
OR D,Linn,Oregon,41043,-122.5244217,44.49045181,91227,39.73,34716,44911,46316,88364,182,1056,799,826,2177,6601,17764,53342,13520,36482,1766,22757,11959,51300,293
OR D,Malheur,Oregon,41045,-117.5650063,43.21748543,26038,2.64,9457,12771,13267,21243,65,224,813,3693,5155,2135,5824,14022,4057,10649,1192,6066,3391,46300,227
OR D,Marion,Oregon,41047,-122.8087341,44.97948837,228483,192.98,83494,113403,115080,209006,2132,3292,4075,9978,18225,16913,43375,135435,32760,86869,3375,52510,30984,59900,335
OR D,Morrow,Oregon,41049,-119.5694809,45.45060158,7625,3.73,2803,3862,3763,6829,8,75,30,683,825,597,1715,4418,895,3412,609,1906,897,43500,247
OR D,Multnomah,Oregon,41051,-122.664578,45.57622337,583887,1354.73,242140,283849,300038,507890,35133,6734,27326,6804,18390,41696,93224,369574,79393,255751,13611,133981,108159,61800,347
OR D,Polk,Oregon,41053,-123.3789291,44.88982964,49541,66.86,18167,23895,25646,46206,200,749,671,1715,2802,3401,9703,29030,7407,18978,811,12064,6103,63600,300
OR D,Sherman,Oregon,41055,-120.7002335,45.40592194,1918,2.32,784,983,935,1864,0,24,13,17,28,153,380,1062,323,900,116,518,266,30600,214
OR D,Tillamook,Oregon,41057,-123.6517448,45.4059639,21570,19.59,8846,10619,10951,21001,39,239,163,128,374,1312,3763,11993,4502,13324,4478,6306,2540,61300,277
OR D,Umatilla,Oregon,41059,-118.7063522,45.4942131,59249,18.41,22020,29978,29271,52743,371,1850,533,3752,5307,4470,12036,34532,8211,24333,2313,13647,8373,47800,252
OR D,Union,Oregon,41061,-117.9743881,45.40192986,23598,11.6,9035,11634,11964,22830,100,248,281,139,381,1632,4913,13717,3336,9974,939,5823,3212,43900,243
OR D,Wallowa,Oregon,41063,-117.2255364,45.53695869,6911,2.19,2796,3426,3485,6826,6,35,25,19,113,473,1370,3831,1237,3755,959,1935,861,47400,220
OR D,Wasco,Oregon,41065,-121.0942307,45.25889397,21683,9.1,8607,10514,11169,19907,67,896,240,573,1065,1499,4358,12040,3786,10476,1869,5601,3006,50000,275
OR D,Washington,Oregon,41067,-123.1126404,45.54169273,311554,429.73,118997,152313,159241,286459,2058,1779,13424,7834,14401,24406,59180,196402,31566,124716,5719,72336,46661,85500,429
OR D,Wheeler,Oregon,41069,-120.0712471,44.67997551,1396,0.81,584,695,701,1382,1,11,2,0,12,76,233,788,299,782,198,413,171,30400,167
OR D,Yamhill,Oregon,41071,-123.3249741,45.24883842,65551,91.68,22424,32862,32689,62135,370,823,783,1440,4129,4909,13665,38329,8648,23194,770,15168,7256,62300,328
PA ED,Berks,Pennsylvania,42011,-75.98551941,40.41120148,336523,390.85,127649,162646,173877,314561,10003,333,2746,8880,17174,22510,55936,205551,52526,134482,6833,94336,33313,81800,342
PA ED,Bucks,Pennsylvania,42017,-75.11020279,40.32430267,541174,887.17,190507,266445,274729,514240,15313,566,8446,2609,8895,39755,99184,343323,58912,199934,9427,144138,46369,140000,524
PA ED,Chester,Pennsylvania,42029,-75.75730133,39.98960686,376396,496.56,133257,184421,191975,344931,23995,510,4070,2890,8565,27972,66053,241394,40977,139597,6340,99333,33924,155900,496
PA ED,Delaware,Pennsylvania,42045,-75.42996597,39.93268967,547651,2976.36,201374,261103,286548,473741,61394,609,10002,1905,5998,38266,88344,336109,84932,211024,9650,146281,55093,113200,445
PA ED,Lancaster,Pennsylvania,42071,-76.31295776,40.01992416,422822,444.14,150956,205282,217540,397815,10038,484,4652,9833,15639,33462,78474,255417,55469,156462,5506,104752,46204,89400,363
PA ED,Lehigh,Pennsylvania,42077,-75.61996078,40.60380554,291130,836.58,112887,139940,151190,271674,6776,320,3661,8699,15001,19342,46602,180321,44865,118335,5448,78248,34639,97800,400
PA ED,Montgomery,Pennsylvania,42091,-75.35871124,40.21357918,678111,1395.29,254995,325999,352112,620087,39124,752,15995,2153,8357,45837,107068,423213,101993,265856,10861,184317,70678,143400,521
PA ED,Northampton,Pennsylvania,42095,-75.33695984,40.75008965,247105,657.19,90955,120190,126915,232785,5269,209,2709,6133,11591,16479,40847,152760,37019,95345,4390,66907,24048,105400,381
PA ED,Philadelphia,Pennsylvania,42101,-75.12598419,39.9923954,1585577,11658.65,603075,737763,847814,848586,631936,3454,43522,58079,89193,115871,263550,965442,240714,674899,71824,373601,229474,49400,358
PA ED,Schuylkill,Pennsylvania,42107,-76.23182297,40.72277069,152585,195.12,60773,73486,79099,150987,842,111,496,149,677,8773,24885,88378,30549,66457,5684,47461,13312,38200,222
PA MD,Adams,Pennsylvania,42001,-77.22257614,39.89586258,78274,150.24,28067,38215,40059,76355,926,85,368,540,1216,5499,14096,48045,10634,30141,2074,20578,7489,79600,300
PA MD,Bradford,Pennsylvania,42015,-76.52462006,41.77337837,60967,52.92,22492,29629,31338,60409,149,117,214,78,218,4355,12192,35480,8940,27058,4566,16930,5562,50900,231
PA MD,Cameron,Pennsylvania,42023,-78.21051788,41.41985321,5913,14.86,2395,2890,3023,5880,7,15,6,5,3,427,1086,3305,1095,4399,2004,1752,643,39800,184
PA MD,Carbon,Pennsylvania,42025,-75.74046326,40.93647385,56846,148.04,21989,27441,29405,56403,119,45,176,103,509,3501,9503,33361,10481,27380,5391,17128,4861,62900,255
PA MD,Centre,Pennsylvania,42027,-77.76749039,40.97408295,123786,111.92,42683,64072,59714,116552,2801,179,3841,413,1350,6896,15723,90058,11109,46195,3512,25531,17152,74700,401
PA MD,Clearfield,Pennsylvania,42033,-78.42559052,40.98937988,78097,67.97,29808,37658,40439,77609,176,87,182,43,200,5113,14533,45464,12987,34300,4492,23414,6394,40000,207
PA MD,Clinton,Pennsylvania,42035,-77.62195587,41.22070503,37182,41.73,13844,17825,19357,36857,144,49,117,15,91,2169,6484,22585,5944,16478,2634,10083,3761,46300,214
PA MD,Columbia,Pennsylvania,42037,-76.4304924,41.0436039,63202,130.05,23478,29919,33283,62588,268,38,228,80,341,3747,10042,39439,9974,25598,2120,17248,6230,54800,241
PA MD,Cumberland,Pennsylvania,42041,-77.24010468,40.14163017,195257,356.96,73452,94366,100891,189037,3062,254,2495,409,1355,11613,31315,126188,26141,77108,3656,52709,20743,85000,378
PA MD,Dauphin,Pennsylvania,42043,-76.78847122,40.40160942,237813,450.4,95264,113672,124141,195881,35609,340,2770,3213,6024,16576,39049,148176,34012,102684,7420,60708,34556,71300,357
PA MD,Franklin,Pennsylvania,42055,-77.77921295,40.00601578,121082,156.44,45675,58764,62318,117072,2771,176,619,444,1065,8018,21513,74053,17498,48629,2954,33193,12482,70500,273
PA MD,Fulton,Pennsylvania,42057,-78.12607574,39.94317818,13837,31.59,5139,6862,6975,13669,125,22,17,4,31,980,2726,8335,1796,6184,1045,4049,1090,50700,210
PA MD,Huntingdon,Pennsylvania,42061,-77.97491455,40.40249443,44164,50.36,15527,22849,21315,41994,1982,53,83,52,195,2804,7583,27826,5951,19286,3759,11845,3682,43100,197
PA MD,Juniata,Pennsylvania,42067,-77.50049551,40.48225975,20625,52.61,7598,10146,10479,20529,27,18,41,10,49,1393,3930,12315,2987,8505,907,5885,1713,51700,184
PA MD,Lackawanna,Pennsylvania,42069,-75.64447403,41.40320587,219039,475.14,84528,102389,116650,215634,1572,163,1364,306,1089,13229,34722,127895,43193,91707,7179,56625,27903,68900,253
PA MD,Lebanon,Pennsylvania,42075,-76.41706848,40.37551689,113744,313.34,42688,55512,58232,110904,706,93,917,1124,2666,7637,20125,68912,17070,44634,1946,30315,12373,71000,293
PA MD,Luzerne,Pennsylvania,42079,-75.96469498,41.16210365,328149,368.29,128483,155217,172932,321906,3958,224,1488,573,2023,19201,50983,193248,64717,138724,10241,89109,39374,56000,243
PA MD,Lycoming,Pennsylvania,42081,-77.02683258,41.33659363,118710,95.97,44949,57265,61445,115040,2816,219,469,166,641,8165,21391,71214,17940,49580,4631,31332,13617,54900,256
PA MD,Mifflin,Pennsylvania,42087,-77.60198975,40.61121941,46197,111.86,17697,22131,24066,45939,108,31,98,21,132,3251,8261,27302,7383,19641,1944,12887,4810,44800,204
PA MD,Monroe,Pennsylvania,42089,-75.31002426,41.03457832,95709,157.16,34206,47097,48612,92766,1727,130,666,420,2052,7048,16754,59408,12499,54823,20617,25905,8301,116500,432
PA MD,Montour,Pennsylvania,42093,-76.66346359,41.02557564,17735,135.38,6543,8308,9427,17472,76,7,138,42,116,1259,3062,10488,2926,6885,342,4686,1857,62200,256
PA MD,Northumberland,Pennsylvania,42097,-76.66739273,40.89234924,96771,209.92,38736,45866,50905,95997,326,79,180,189,532,5996,16435,56053,18287,41900,3164,28399,10337,39500,205
PA MD,Perry,Pennsylvania,42099,-77.29343033,40.41421127,41172,73.92,14949,20488,20684,40916,95,50,69,42,194,2993,8105,25505,4569,17063,2114,11889,3060,64400,262
PA MD,Pike,Pennsylvania,42103,-75.02656937,41.34208298,27966,50.85,10536,13861,14105,27420,256,48,133,109,651,2254,4809,16546,4357,30852,20316,8775,1761,117700,445
PA MD,Potter,Pennsylvania,42105,-77.90769958,41.73677254,16717,15.46,6246,8121,8596,16629,20,29,31,8,72,1188,3403,9372,2754,11334,5088,4707,1539,40900,216
PA MD,Snyder,Pennsylvania,42109,-77.08678436,40.76260948,36680,111.49,12764,17909,18771,36347,146,30,95,62,148,2676,6641,22747,4616,13629,865,9848,2916,56700,234
PA MD,Sullivan,Pennsylvania,42113,-76.52031708,41.43547821,6104,13.53,2280,3056,3048,6001,59,30,9,5,25,326,1084,3419,1275,5458,3178,1791,489,47000,179
PA MD,Susquehanna,Pennsylvania,42115,-75.8058815,41.8209095,40380,48.89,14898,19929,20451,40086,79,83,87,45,162,2922,7916,23357,6185,20308,5410,11798,3100,64200,254
PA MD,Tioga,Pennsylvania,42117,-77.24712372,41.77357483,41126,36.36,14974,20041,21085,40648,227,108,106,37,139,2687,7707,24581,6151,18202,3228,11298,3676,43900,202
PA MD,Union,Pennsylvania,42119,-77.09615326,40.98008347,36176,114.12,11689,18681,17495,34784,972,76,239,105,638,2381,5919,23328,4548,12886,1197,8719,2970,66800,276
PA MD,Wayne,Pennsylvania,42127,-75.27400208,41.61888313,39944,54.64,14638,19803,20141,39470,282,43,97,52,371,2663,7389,23126,6766,28480,13842,11600,3038,89800,299
PA MD,Wyoming,Pennsylvania,42131,-76.00655746,41.51819992,28076,70.37,10002,13865,14211,27798,135,25,81,37,135,2006,5732,16801,3537,11857,1855,7687,2315,67600,267
PA MD,York,Pennsylvania,42133,-76.68825531,39.97425842,339574,374.81,128666,166164,173410,323339,10985,416,2103,2731,5165,23688,58576,212867,44443,134761,6095,95670,32996,79700,329
PA WD,Allegheny,Pennsylvania,42003,-80.0325737,40.43687248,1336449,1838.31,541261,626732,709717,1169452,149550,1452,13469,2526,8731,84113,198070,822355,231911,580738,39477,358068,183193,57100,315
PA WD,Armstrong,Pennsylvania,42005,-79.45817947,40.85142517,73478,113.74,28309,35325,38153,72727,566,59,81,45,164,4432,13250,42909,12887,31757,3448,21615,6694,44300,205
PA WD,Beaver,Pennsylvania,42007,-80.33715057,40.66771126,186093,426.82,71939,88661,97432,174759,10475,203,377,279,1124,11728,31694,111151,31520,76336,4397,52729,19210,50500,230
PA WD,Bedford,Pennsylvania,42009,-78.47668839,40.02483749,47919,47.12,18038,23413,24506,47607,150,40,78,44,118,3064,8952,28556,7347,21738,3700,14268,3770,46800,189
PA WD,Blair,Pennsylvania,42013,-78.37413406,40.49660492,130542,247.71,50332,61526,69016,128840,1073,118,380,131,431,8237,23583,76568,22154,54349,4017,36517,13815,41100,224
PA WD,Butler,Pennsylvania,42019,-79.93207169,40.9186306,152013,192.67,55325,74138,77875,150407,810,109,545,142,563,10278,27337,93917,20481,59061,3736,42379,12946,62900,275
PA WD,Cambria,Pennsylvania,42021,-78.71199036,40.48228645,163029,235.93,62004,78112,84917,158584,3734,109,384,218,985,9316,28654,94477,30582,67374,5370,45455,16549,39900,191
PA WD,Clarion,Pennsylvania,42031,-79.45517349,41.20281792,41699,68.7,14990,20127,21572,41187,200,66,210,36,116,2424,7261,26221,5793,18022,3032,10870,4120,46200,209
PA WD,Crawford,Pennsylvania,42039,-80.07230377,41.66534996,86169,85.23,32185,41833,44336,84615,1072,112,272,98,303,5855,16483,50530,13301,40462,8277,23627,8558,43200,210
PA WD,Elk,Pennsylvania,42047,-78.66738129,41.41721344,34878,42.02,13131,17135,17743,34702,15,35,98,28,56,2386,6568,20348,5576,17249,4118,10467,2664,49900,209
PA WD,Erie,Pennsylvania,42049,-80.06772232,42.05899429,275572,342.75,101564,132971,142601,257879,14304,438,1411,1540,3364,19973,51464,166110,38025,108585,7021,69705,31859,54000,248
PA WD,Fayette,Pennsylvania,42051,-79.65678406,39.92811012,145351,183.06,56110,69080,76271,139773,5116,139,219,104,452,8812,26271,84192,26076,61406,5296,40595,15515,39700,196
PA WD,Forest,Pennsylvania,42053,-79.24359512,41.47412682,4802,11.22,1908,2475,2327,4731,43,11,3,14,23,261,856,2715,970,8445,6537,1546,362,35700,191
PA WD,Greene,Pennsylvania,42059,-80.21783447,39.87066269,39550,68.54,14624,18805,20745,38948,377,69,112,44,209,2515,7620,22914,6501,15982,1358,10603,4021,38400,187
PA WD,Indiana,Pennsylvania,42063,-79.13550949,40.64172363,89994,108.56,31710,43366,46628,88033,1175,92,574,120,370,5238,15755,56594,12407,34770,3060,23314,8396,50500,254
PA WD,Jefferson,Pennsylvania,42065,-78.9647789,41.14279556,46083,70.14,17608,22266,23817,45891,49,49,70,24,98,3001,8694,26444,7944,21242,3634,13585,4023,42500,203
PA WD,Lawrence,Pennsylvania,42073,-80.31425095,40.99183846,96246,265.14,36350,45634,50612,92896,2915,61,274,100,357,5966,16644,55853,17783,38844,2494,27671,8679,41500,211
PA WD,McKean,Pennsylvania,42083,-78.58198166,41.80373573,47131,48.14,17837,23217,23914,46147,520,111,161,192,511,3048,8607,27594,7882,21454,3617,13201,4636,37400,219
PA WD,Mercer,Pennsylvania,42085,-80.26284027,41.28015137,121003,180.06,45591,58658,62345,114479,5882,115,393,134,506,7530,20848,71848,20777,48689,3098,34184,11407,41900,221
PA WD,Somerset,Pennsylvania,42111,-79.03951645,40.0025959,78218,72.9,29574,37728,40490,77875,102,43,143,55,231,5017,14536,45413,13252,35713,6139,22881,6693,43400,196
PA WD,Venango,Pennsylvania,42121,-79.74337387,41.40066719,59381,87.45,22408,28774,30607,58636,497,55,138,55,201,3914,11476,35070,8921,26961,4553,16692,5716,38600,209
PA WD,Warren,Pennsylvania,42123,-79.26940155,41.81365204,45050,50.9,17244,21945,23105,44782,53,74,111,30,116,3024,8320,26653,7053,22236,4992,13311,3933,43900,228
PA WD,Washington,Pennsylvania,42125,-80.18662262,40.21606445,204584,238.44,78533,97915,106669,196810,6786,201,543,244,1186,11876,34079,122859,35770,84113,5580,59368,19165,53600,241
PA WD,Westmoreland,Pennsylvania,42129,-79.44194031,40.35860252,370321,358.49,144080,177143,193178,361103,6930,262,1566,460,1359,22122,60998,223729,63472,153554,9474,110003,34077,56800,247
RI D,Bristol,Rhode Island,44001,-71.29868698,41.72577095,48859,1879.19,17559,23723,25136,48250,186,39,297,87,672,3187,7557,30417,7698,18567,1008,12514,5045,162100,417
RI D,Kent,Rhode Island,44003,-71.58130264,41.68113136,161135,936.83,62058,77192,83943,158122,1050,296,1289,378,1737,10154,26182,100563,24236,65450,3392,44709,17349,122500,468
RI D,Newport,Rhode Island,44005,-71.23383713,41.56207657,87194,814.9,32687,43431,43763,81838,3396,352,1061,547,1712,5728,13918,56245,11303,37475,4788,19416,13271,160900,551
RI D,Providence,Rhode Island,44007,-71.5590744,41.86755943,596270,1433.34,226362,283478,312792,522953,33171,2360,14233,23553,40569,40644,92954,368870,93802,243224,16862,121071,105291,127400,393
RI D,Washington,Rhode Island,44009,-71.64345551,41.48739052,110006,330.35,39311,53672,56334,106212,1058,1024,1445,267,1062,7256,18110,71132,13508,49856,10545,27082,12229,152700,497
SC D,Abbeville,South Carolina,45001,-82.48996735,34.24720383,23862,46.97,8780,11310,12552,16244,7529,17,53,19,98,1671,4494,14177,3520,9846,1066,7035,1745,43600,158
SC D,Aiken,South Carolina,45003,-81.60303497,33.53508949,120940,110.75,44883,58596,62344,90684,29241,218,545,252,867,9029,23990,74125,13796,49266,4383,33491,11392,61700,268
SC D,Allendale,South Carolina,45005,-81.3407135,32.94913483,11722,28.38,3791,5937,5785,3642,7968,11,7,94,161,896,2563,6777,1486,4242,451,2584,1207,39100,123
SC D,Anderson,South Carolina,45007,-82.64842224,34.5112133,145196,202.22,55481,69436,75760,120384,24151,173,340,148,559,9528,26552,89384,19732,60745,5264,41697,13784,53700,224
SC D,Bamberg,South Carolina,45009,-81.00895309,33.2291832,16902,42.79,5587,7921,8981,6472,10371,22,20,17,75,1225,3681,9831,2165,6408,821,4052,1535,43100,132
SC D,Barnwell,South Carolina,45011,-81.47647476,33.28882599,20293,36.37,7100,9739,10554,11510,8693,32,17,41,146,1647,4528,11629,2489,7854,754,5194,1906,44900,165
SC D,Beaufort,South Carolina,45013,-80.72529602,32.38533401,86425,149.27,30712,43803,42622,59843,24582,251,813,936,2168,7387,14431,53943,10664,45981,15269,19941,10771,112100,423
SC D,Berkeley,South Carolina,45015,-79.90247345,33.18775368,128776,116.22,42386,64972,63804,93900,31111,391,2637,737,2599,12622,29129,79572,7453,45697,3311,29533,12853,68500,357
SC D,Calhoun,South Carolina,45017,-80.7737236,33.67124176,12753,33.56,4487,6042,6711,6152,6575,12,9,5,39,924,2547,7514,1768,5225,738,3674,813,45000,127
SC D,Charleston,South Carolina,45019,-80.16729355,32.76342201,295039,314.54,107069,146565,148474,187553,102988,673,2690,1135,3873,23642,49963,191553,29881,123550,16481,61641,45428,73800,346
SC D,Cherokee,South Carolina,45021,-81.6163826,35.01075172,44506,112.39,16456,21328,23178,34981,9171,65,193,96,259,3105,8589,27034,5778,17610,1154,12383,4073,46900,201
SC D,Chester,South Carolina,45023,-81.17709732,34.67877388,32170,55.47,11448,15210,16960,19178,12852,71,36,33,80,2413,6575,18889,4293,12293,845,8748,2700,40700,169
SC D,Chesterfield,South Carolina,45025,-80.1749649,34.59360313,38577,48.1,14047,18440,20137,25549,12902,65,31,30,160,2729,7885,23042,4921,15101,1054,10589,3458,42200,167
SC D,Clarendon,South Carolina,45027,-80.20882416,33.69295692,28450,47.26,9544,13559,14891,12267,16078,31,28,46,144,2206,6222,16235,3787,12101,2557,7386,2158,45900,119
SC D,Colleton,South Carolina,45029,-80.72715378,32.84035873,34377,32.68,12040,16407,17970,18671,15469,165,38,34,176,2607,7499,19877,4394,14926,2886,9560,2480,47400,177
SC D,Darlington,South Carolina,45031,-79.97592545,34.30838585,61851,109.86,21999,29079,32772,36888,24773,71,66,53,211,4357,13112,36965,7417,23601,1602,16418,5581,49000,172
SC D,Dillon,South Carolina,45033,-79.3554039,34.42164803,29114,71.71,9887,13521,15593,15877,12735,426,65,11,76,2340,6845,16364,3565,10590,703,6622,3265,40800,142
SC D,Dorchester,South Carolina,45035,-80.43844986,33.07386017,83060,144.45,28213,41419,41641,62323,19128,549,786,274,1040,7317,17251,52356,6136,30632,2419,20034,8179,73600,335
SC D,Edgefield,South Carolina,45037,-81.91493225,33.75725365,18375,37.5,6424,8887,9488,9796,8516,11,29,23,79,1440,3853,10832,2250,7290,866,4904,1520,52100,161
SC D,Fairfield,South Carolina,45039,-81.09496689,34.37018585,22295,32.55,7467,10689,11606,9244,12994,14,32,11,105,1606,4737,12911,3041,8730,1263,5831,1636,47500,151
SC D,Florence,South Carolina,45041,-79.69114685,34.04087257,114344,142.22,40217,53900,60444,69501,44276,145,307,115,508,8364,24092,69165,12723,43209,2992,28346,11871,54900,224
SC D,Georgetown,South Carolina,45043,-79.33958435,33.46151924,46302,56.33,16275,22009,24293,26151,19980,49,61,61,187,3565,10253,26530,5954,21134,4859,12921,3354,63800,232
SC D,Greenville,South Carolina,45045,-82.45658112,34.84467316,320167,402.73,122878,153873,166294,259160,57646,467,2139,755,3028,22585,56244,203275,38063,131645,8767,81320,41558,66300,292
SC D,Greenwood,South Carolina,45047,-82.0982132,34.17706871,59567,132.08,22730,27938,31629,41239,17970,51,237,70,251,4138,11066,36139,8224,24735,2005,15717,7013,50100,215
SC D,Hampton,South Carolina,45049,-81.1242485,32.79021072,18191,32.43,6322,8536,9655,8279,9884,6,18,4,71,1532,4277,10133,2249,7058,736,4705,1617,43700,138
SC D,Horry,South Carolina,45051,-78.95698929,33.93851662,144053,126.03,55764,70516,73537,117098,25160,340,1128,327,1259,9534,24777,91513,18229,89960,34196,38198,17566,75600,350
SC D,Jasper,South Carolina,45053,-81.04825592,32.40942574,15487,23.64,5298,7416,8071,6529,8889,20,32,17,69,1368,3537,8633,1949,6070,772,4132,1166,44400,180
SC D,Kershaw,South Carolina,45055,-80.57633972,34.33853912,43599,60.3,15810,20986,22613,31039,12337,70,100,53,245,2937,8874,26496,5292,17479,1669,12873,2937,60200,218
SC D,Lancaster,South Carolina,45057,-80.66017532,34.75734138,54516,98.76,19778,26065,28451,40536,13820,61,64,35,212,4019,10626,33162,6709,20929,1151,14796,4982,49400,210
SC D,Laurens,South Carolina,45059,-81.97621536,34.48978996,58092,81.59,20660,27844,30248,41493,16386,45,95,73,211,3963,10784,35540,7805,23201,2541,15685,4975,44700,197
SC D,Lee,South Carolina,45061,-80.23234558,34.16074944,18437,44.86,6054,8608,9829,6850,11516,17,29,25,75,1386,4269,10513,2269,6537,483,4767,1287,42000,142
SC D,Lexington,South Carolina,45063,-81.24221039,33.9213295,167611,237.07,61633,81668,85943,147391,18512,330,1010,368,1302,12172,32385,108157,14897,67556,5923,46900,14733,74900,331
SC D,Marion,South Carolina,45067,-79.34740829,33.99542618,33899,68.76,11766,15401,18498,15152,18505,86,128,28,110,2520,8059,19080,4240,12777,1011,8389,3377,42600,154
SC D,Marlboro,South Carolina,45069,-79.68888092,34.55098724,29361,60.79,10163,13882,15479,14308,14249,733,26,45,79,2154,6376,17078,3753,10955,792,7003,3160,37100,162
SC D,McCormick,South Carolina,45065,-82.31845474,33.83481216,8868,25.34,2731,4792,4076,3647,5190,6,11,14,26,462,1677,5567,1162,3347,616,2111,620,39200,122
SC D,Newberry,South Carolina,45071,-81.62307739,34.2931118,33172,52.32,12314,15825,17347,21488,11507,45,92,40,147,2244,6132,19673,5123,14455,2141,9376,2938,49200,183
SC D,Oconee,South Carolina,45073,-83.09680176,34.76304817,57494,91.41,22358,28229,29265,52038,5060,72,172,152,528,3571,10487,35531,7905,25983,3625,17196,5162,56900,208
SC D,Orangeburg,South Carolina,45075,-80.79413223,33.44023705,84803,76.33,28909,39559,45244,34949,49257,214,322,61,331,6194,17688,50374,10547,32340,3431,21165,7744,50500,173
SC D,Pickens,South Carolina,45077,-82.70968628,34.84337234,93894,188.16,33422,46678,47216,86045,6817,160,768,104,571,5685,15093,62632,10484,35865,2443,24461,8961,59800,253
SC D,Richland,South Carolina,45079,-80.96711731,33.99823761,285720,374.96,101590,138911,146809,160063,119394,683,3810,1770,4647,19895,48874,189818,27133,109564,7974,60157,41433,71200,343
SC D,Saluda,South Carolina,45081,-81.73844528,33.99497795,16357,35.87,5824,7963,8394,10871,5417,16,9,44,86,1071,3254,9682,2350,6792,968,4752,1072,46600,145
SC D,Spartanburg,South Carolina,45083,-81.96372604,34.8877182,226800,278.62,84503,109230,117570,177427,46871,332,1710,460,1521,15308,40559,142148,28785,89927,5424,58959,25544,54200,257
SC D,Sumter,South Carolina,45085,-80.27282715,33.90464783,102637,154.34,32723,51343,51294,56779,44340,204,933,381,1239,8574,20843,63599,9621,35016,2293,21328,11395,56900,241
SC D,Union,South Carolina,45087,-81.63529968,34.67720413,30337,58.91,11407,14099,16238,21176,9082,26,38,15,69,1891,5660,18292,4494,12230,823,8769,2638,38000,163
SC D,Williamsburg,South Carolina,45089,-79.70812607,33.59237671,36815,39.42,12108,17198,19617,13092,23643,15,28,37,129,2872,9108,20397,4438,13265,1157,9587,2521,42600,132
SC D,York,South Carolina,45091,-81.17863464,34.98885727,131497,191.97,47006,63181,68316,103515,26349,785,680,168,735,9642,24430,83424,14001,50438,3432,33774,13232,71300,298
SD D,Aurora,South Dakota,46003,-98.56965256,43.71527481,3135,4.43,1146,1581,1554,3086,0,42,3,4,7,183,738,1533,681,1342,196,879,267,15500,128
SD D,Beadle,South Dakota,46005,-98.2803421,44.41430283,18253,14.5,7341,8874,9379,17937,70,161,52,33,76,1307,3584,10032,3330,8093,752,4831,2510,34200,198
SD D,Bennett,South Dakota,46007,-101.6742592,43.19067192,3206,2.71,1030,1567,1639,1709,8,1481,2,6,35,305,842,1680,379,1292,262,669,361,29500,164
SD D,Bon Homme,South Dakota,46009,-97.90105057,42.9691391,7089,12.84,2647,3619,3470,6900,22,155,4,8,34,465,1310,3720,1594,3087,440,2006,641,25100,141
SD D,Brookings,South Dakota,46011,-96.7935524,44.36785126,25207,31.71,8910,12866,12341,24656,77,156,300,18,76,1525,4222,16479,2981,9824,914,5221,3689,51200,254
SD D,Brown,South Dakota,46013,-98.35499954,45.59134483,35580,20.66,13867,17051,18529,34382,45,982,140,31,111,2472,6696,21050,5362,15101,1234,8724,5143,46600,243
SD D,Brule,South Dakota,46015,-99.13130569,43.71619225,5485,6.73,1996,2736,2749,5078,6,383,12,6,31,415,1401,2759,910,2275,279,1448,548,41300,179
SD D,Buffalo,South Dakota,46017,-99.25365067,44.06500053,1759,3.7,446,923,836,393,0,1365,0,1,3,221,565,841,132,535,89,189,257,14999,99
SD D,Butte,South Dakota,46019,-103.5103569,44.89362717,7914,3.52,3033,3920,3994,7629,21,117,17,130,219,641,1670,4337,1266,3502,469,2061,972,38700,195
SD D,Campbell,South Dakota,46021,-100.1161385,45.77003288,1965,2.68,767,986,979,1960,2,3,0,0,0,139,362,1065,399,944,177,633,134,16400,135
SD D,Charles Mix,South Dakota,46023,-98.68980026,43.17137909,9131,8.38,3232,4481,4650,7122,4,1995,4,6,34,807,2121,4596,1607,3751,519,2196,1036,27200,127
SD D,Clark,South Dakota,46025,-97.74006653,44.84886742,4403,4.62,1700,2195,2208,4376,6,12,7,2,13,289,961,2198,955,2026,326,1332,368,18700,131
SD D,Clay,South Dakota,46027,-96.98764801,42.8956356,13186,32.24,4433,6401,6785,12556,58,395,146,31,100,761,1875,9186,1364,4892,459,2346,2087,47800,240
SD D,Codington,South Dakota,46029,-97.19309998,44.97836494,22698,32.71,8739,11017,11681,22345,16,260,72,5,55,1683,4821,12572,3622,9539,800,5909,2830,50600,228
SD D,Corson,South Dakota,46031,-101.1524277,45.70875549,4195,1.7,1303,2132,2063,2151,1,2034,3,6,47,452,1146,2141,456,1557,254,772,531,18100,106
SD D,Custer,South Dakota,46033,-103.3758278,43.66503525,6179,3.96,2352,3126,3053,6000,9,155,11,4,45,372,1343,3538,926,3003,651,1692,660,45200,220
SD D,Davison,South Dakota,46035,-98.14810562,43.67049789,17503,40.14,6948,8342,9161,17162,22,243,62,14,38,1319,3503,9637,3044,7490,542,4202,2746,38400,215
SD D,Day,South Dakota,46037,-97.60658264,45.37242317,6978,6.83,2732,3435,3543,6500,1,468,5,4,11,502,1390,3468,1618,3914,1182,2016,716,22500,156
SD D,Deuel,South Dakota,46039,-96.67238617,44.75561905,4522,7.17,1767,2309,2213,4498,1,10,9,4,14,316,891,2378,937,2208,441,1387,380,23100,171
SD D,Dewey,South Dakota,46041,-100.8863106,45.10355186,5523,2.39,1721,2711,2812,1820,11,3680,8,4,46,680,1542,2842,459,2123,402,846,875,23700,99
SD D,Douglas,South Dakota,46043,-98.41296005,43.34810257,3746,8.63,1352,1844,1902,3721,0,22,2,1,2,315,823,1825,783,1517,165,1063,289,19600,133
SD D,Edmunds,South Dakota,46045,-99.22003174,45.42316437,4356,3.79,1669,2164,2192,4329,1,19,4,3,5,296,869,2193,998,2004,335,1325,344,22700,140
SD D,Fall River,South Dakota,46047,-103.5297394,43.23890495,7353,4.23,2864,3808,3545,6807,27,450,30,39,120,376,1415,4035,1527,3692,828,1878,986,34100,205
SD D,Faulk,South Dakota,46049,-99.14808273,45.07188225,2744,2.73,1057,1366,1378,2737,0,6,1,0,3,195,540,1437,572,1286,229,847,210,17900,140
SD D,Grant,South Dakota,46051,-96.84146881,45.15169907,8372,12.29,3154,4154,4218,8314,3,33,17,5,11,588,1898,4377,1509,3549,395,2309,845,36600,186
SD D,Gregory,South Dakota,46053,-99.01545715,43.24792862,5359,5.29,2139,2607,2752,5065,1,284,5,4,27,389,1154,2605,1211,2595,456,1562,577,26300,136
SD D,Haakon,South Dakota,46055,-101.5290375,44.37153435,2624,1.44,926,1284,1340,2569,4,36,12,3,11,197,734,1313,380,1071,145,678,248,33800,168
SD D,Hamlin,South Dakota,46057,-97.1935463,44.67142105,4974,9.71,1854,2444,2530,4944,4,10,7,9,13,343,1094,2411,1126,2500,646,1442,412,22800,131
SD D,Hand,South Dakota,46059,-99.00930405,44.546978,4272,2.97,1625,2102,2170,4251,3,5,11,2,11,291,886,2226,869,2053,428,1156,469,32600,153
SD D,Hanson,South Dakota,46061,-97.78837585,43.67055893,2994,6.91,1072,1505,1489,2987,0,7,0,0,2,221,701,1588,484,1232,160,802,270,19900,152
SD D,Harding,South Dakota,46063,-103.4974899,45.57708549,1669,0.62,592,865,804,1645,5,16,0,3,3,147,407,886,229,776,184,434,158,33300,150
SD D,Hughes,South Dakota,46065,-100.0979195,44.32915497,14817,19.57,5780,7067,7750,13726,19,994,43,35,112,1154,3270,8630,1763,6255,475,3653,2127,58700,272
SD D,Hutchinson,South Dakota,46067,-97.75737381,43.33410072,8262,10.13,3221,4103,4159,8221,1,22,11,7,14,520,1561,4046,2135,3657,436,2549,672,25000,141
SD D,Hyde,South Dakota,46069,-99.48948288,44.54688454,1696,1.97,680,803,893,1637,1,57,1,0,7,119,327,853,397,816,136,491,189,21900,140
SD D,Jackson,South Dakota,46071,-101.6070023,43.69472313,2811,1.5,903,1408,1403,1609,3,1193,5,1,14,284,721,1452,354,1147,244,575,328,22100,135
SD D,Jerauld,South Dakota,46073,-98.63310623,44.06500053,2425,4.58,966,1202,1223,2413,0,5,7,0,1,131,505,1201,588,1182,216,703,263,18200,140
SD D,Jones,South Dakota,46075,-100.70644,43.94825554,1324,1.36,519,686,638,1316,0,7,1,0,1,102,270,725,227,699,180,399,120,23400,170
SD D,Kingsbury,South Dakota,46077,-97.49380875,44.36811829,5925,7.19,2357,2872,3053,5905,0,11,7,2,5,389,1151,2977,1408,2765,408,1739,618,22800,146
SD D,Lake,South Dakota,46079,-97.13280106,44.01957703,10550,18.84,4030,5133,5417,10468,12,33,22,15,27,707,2097,5829,1917,5148,1118,2722,1308,37600,186
SD D,Lawrence,South Dakota,46081,-103.7577972,44.37676048,20655,25.82,7926,10163,10492,19950,29,535,56,85,327,1425,4187,12091,2952,9092,1166,5086,2840,52300,250
SD D,Lincoln,South Dakota,46083,-96.68845367,43.29355812,15427,26.69,5461,7671,7756,15292,21,58,42,14,23,1238,3507,8473,2209,5823,362,4331,1130,49100,207
SD D,Lyman,South Dakota,46085,-99.8286171,43.86228371,3638,2.17,1268,1852,1786,2579,3,1051,2,3,18,331,883,1938,486,1523,255,930,338,30200,135
SD D,Marshall,South Dakota,46091,-97.60435867,45.74753952,4844,5.71,1919,2427,2417,4568,1,271,2,2,13,337,957,2493,1057,2640,721,1400,519,22900,143
SD D,McCook,South Dakota,46087,-97.36798096,43.67047501,5688,9.88,2145,2796,2892,5652,0,28,6,2,8,404,1181,2812,1291,2371,226,1651,494,22500,155
SD D,McPherson,South Dakota,46089,-99.22702026,45.76946831,3228,2.81,1332,1574,1654,3223,1,2,2,0,0,169,556,1614,889,1566,234,1083,249,14999,127
SD D,Meade,South Dakota,46093,-102.789505,44.59467888,21878,6.28,7084,11326,10552,20652,518,395,172,141,387,1920,5172,12632,2154,7592,508,4730,2354,50600,246
SD D,Mellette,South Dakota,46095,-100.7234688,43.62820435,2137,1.63,681,1063,1074,1133,1,999,2,2,15,208,561,1088,280,910,229,449,232,14999,128
SD D,Miner,South Dakota,46097,-97.61420059,44.01974869,3272,5.74,1276,1630,1642,3267,0,4,0,1,6,227,661,1584,800,1474,198,954,322,19600,138
SD D,Minnehaha,South Dakota,46099,-96.79349899,43.67425728,123809,152.85,47681,59568,64241,120454,754,1680,714,207,648,9812,23635,75969,14393,49780,2099,29690,17991,58400,331
SD D,Moody,South Dakota,46101,-96.67389297,44.02191925,6507,12.51,2398,3263,3244,5951,10,527,13,6,13,533,1470,3353,1151,2666,268,1707,691,33100,165
SD D,Pennington,South Dakota,46103,-103.028183,44.10103035,81343,29.23,30553,40299,41044,72769,1288,5835,933,518,1777,7512,16269,49429,8133,33741,3188,18757,11796,56600,320
SD D,Perkins,South Dakota,46105,-102.4819832,45.49143982,3932,1.36,1586,1958,1974,3859,6,56,2,9,17,235,791,2079,827,2007,421,1210,376,25700,142
SD D,Potter,South Dakota,46107,-100.0004997,45.07477379,3190,3.67,1249,1571,1619,3157,0,26,2,5,5,198,686,1621,685,1664,415,941,308,29300,157
SD D,Roberts,South Dakota,46109,-96.85509872,45.61944962,9914,9,3619,4962,4952,7615,0,2280,10,9,28,796,2200,5051,1867,4728,1109,2406,1213,24100,132
SD D,Sanborn,South Dakota,46111,-98.0964241,44.0210247,2833,4.98,1059,1443,1390,2830,0,0,3,0,15,212,601,1483,537,1326,267,818,241,14999,129
SD D,Shannon,South Dakota,46113,-102.5458412,43.34615517,9902,4.73,2205,5021,4881,499,5,9374,5,19,179,1391,3049,4936,526,2699,494,991,1214,14999,108
SD D,Spink,South Dakota,46115,-98.35544586,44.93825912,7981,5.3,3022,3882,4099,7909,2,65,2,3,15,589,1583,4333,1476,3545,523,2142,880,20300,160
SD D,Stanley,South Dakota,46117,-100.873028,44.47729111,2453,1.71,921,1225,1228,2294,1,155,0,3,10,200,574,1413,266,1056,135,678,243,48300,240
SD D,Sully,South Dakota,46119,-100.2023697,44.7231636,1589,1.63,621,807,782,1572,1,15,0,1,3,92,351,904,242,811,190,451,170,28400,174
SD D,Todd,South Dakota,46121,-100.7145233,43.19067192,8352,6.02,2210,4132,4220,1431,10,6883,6,22,123,1154,2613,4110,475,2572,362,1025,1185,14999,110
SD D,Tripp,South Dakota,46123,-99.88300323,43.37690926,6924,4.28,2573,3452,3472,6245,0,670,7,2,9,553,1531,3649,1191,3023,450,1895,678,35600,175
SD D,Turner,South Dakota,46125,-97.16082382,43.29368019,8576,13.9,3332,4214,4362,8542,4,26,4,0,18,538,1751,4359,1928,3800,468,2537,795,22800,145
SD D,Union,South Dakota,46127,-96.62556076,42.78817558,10189,22.49,3859,5025,5164,10091,20,34,27,17,67,725,2255,5516,1693,4286,427,2806,1053,37600,180
SD D,Walworth,South Dakota,46129,-100.0994453,45.42520523,6087,8.61,2447,2939,3148,5606,2,467,11,1,26,397,1180,3237,1273,2928,481,1750,697,27600,207
SD D,Yankton,South Dakota,46135,-97.39857864,42.9851265,19252,37.17,7107,9437,9815,18661,114,412,53,12,89,1426,3668,11280,2878,7571,464,4690,2417,48500,224
SD D,Ziebach,South Dakota,46137,-101.5689888,44.99661064,2220,1.13,630,1109,1111,790,3,1420,4,3,29,264,680,1103,173,800,170,367,263,14999,99
TN ED,Anderson,Tennessee,47001,-84.19517136,36.09956169,68250,201.33,27384,32534,35716,64615,2763,243,547,82,381,4206,12128,41431,10485,29323,1939,19401,7983,55100,262
TN ED,Bedford,Tennessee,47003,-86.44908524,35.51919937,30411,64.02,11608,14750,15661,27097,3068,36,147,63,172,2043,5672,18160,4536,12638,1030,8329,3279,48400,227
TN ED,Bledsoe,Tennessee,47007,-85.16357803,35.56930923,9669,23.76,3261,5263,4406,9242,375,42,3,7,38,573,1795,6140,1161,3771,510,2568,693,36000,143
TN ED,Blount,Tennessee,47009,-83.92222595,35.67012024,85969,154.07,33624,41279,44690,82503,2783,195,409,79,368,5279,14383,53699,12608,36532,2908,25072,8552,60200,239
TN ED,Bradley,Tennessee,47011,-84.85221863,35.17570686,73712,225.42,27604,35531,38181,70132,2900,200,232,248,712,4719,13529,47293,8171,29562,1958,19001,8603,55000,247
TN ED,Campbell,Tennessee,47013,-84.13879776,36.3862133,35079,73.23,13150,16733,18346,34727,130,175,41,6,117,2222,6781,20916,5160,14817,1667,9709,3441,37900,174
TN ED,Carter,Tennessee,47019,-82.13732147,36.2997551,51505,151.04,20189,24875,26630,50763,456,91,144,51,191,2939,8450,32292,7824,21779,1590,15410,4779,43800,202
TN ED,Claiborne,Tennessee,47025,-83.68574905,36.46352577,26137,60.5,9629,12666,13471,25701,250,56,112,18,83,1610,5058,16071,3398,10711,1082,7542,2087,41400,164
TN ED,Cocke,Tennessee,47029,-83.10303116,35.94279099,29141,67.46,11191,14035,15106,28398,613,78,31,21,144,1714,5270,18407,3750,12282,1091,8137,3054,40300,145
TN ED,Coffee,Tennessee,47031,-86.07440567,35.50434875,40339,94.25,15500,19445,20894,38459,1493,84,251,52,261,2771,7608,24336,5624,16786,1286,10862,4638,52800,234
TN ED,Franklin,Tennessee,47051,-86.0945549,35.18079948,34725,63.95,12660,17073,17652,32425,2095,55,95,55,187,2184,6346,21197,4998,13717,1057,9835,2825,48700,210
TN ED,Grainger,Tennessee,47057,-83.49571228,36.25209618,17095,62.62,6394,8473,8622,16939,102,42,8,4,41,1028,3143,10718,2206,7501,1107,5271,1123,40300,161
TN ED,Greene,Tennessee,47059,-82.87075424,36.16859055,55853,90.23,21482,27026,28827,54440,1223,89,70,31,163,3203,9594,35321,7735,23270,1788,16548,4934,44500,194
TN ED,Grundy,Tennessee,47061,-85.7048912,35.38362694,13362,37.01,4784,6460,6902,13294,19,28,6,15,68,861,2857,7729,1915,5155,371,3896,888,29800,155
TN ED,Hamblen,Tennessee,47063,-83.27643585,36.23219872,50480,323.59,19429,24319,26161,47891,2323,85,128,53,175,3118,8964,32362,6036,20514,1085,14009,5420,51300,210
TN ED,Hamilton,Tennessee,47065,-85.20059586,35.22877884,285536,529.75,111799,134764,150772,227413,54477,585,2479,582,1946,18946,50064,178190,38336,122588,10789,71640,40159,62000,285
TN ED,Hancock,Tennessee,47067,-83.15711975,36.49387741,6739,30.22,2484,3320,3419,6596,122,18,1,2,35,412,1289,3980,1058,2890,406,1946,538,32200,99
TN ED,Hawkins,Tennessee,47073,-82.94333649,36.41514587,44565,91.7,17167,21752,22813,43664,741,78,59,23,134,2666,7928,28082,5889,18779,1612,13236,3931,48600,211
TN ED,Jefferson,Tennessee,47089,-83.46554184,36.04400253,33016,124.59,12329,16136,16880,31937,930,75,41,33,100,1796,5442,21379,4399,14170,1841,9519,2810,47900,195
TN ED,Johnson,Tennessee,47091,-81.85014725,36.43740082,13766,46.35,5406,6826,6940,13668,61,14,14,9,32,787,2404,8309,2266,6090,684,4360,1046,41300,147
TN ED,Knox,Tennessee,47093,-83.95687866,35.99357414,335749,663.54,133639,160367,175382,301421,29603,797,3327,601,2067,21426,53686,217947,42690,143582,9943,85369,48270,63900,272
TN ED,Lincoln,Tennessee,47103,-86.57159805,35.1872654,28157,49.31,10881,13581,14576,25583,2422,38,64,50,137,1850,5130,16809,4368,11902,1021,7982,2899,47100,189
TN ED,Loudon,Tennessee,47105,-84.35273361,35.76081276,31255,133,12155,15058,16197,30732,400,52,50,21,83,1951,5381,19370,4553,12995,840,9428,2727,51000,190
TN ED,Marion,Tennessee,47115,-85.61519623,35.15790558,24860,48.55,9215,12118,12742,23749,1035,36,32,8,85,1643,4884,15298,3035,10011,796,7284,1931,42600,192
TN ED,McMinn,Tennessee,47107,-84.62614441,35.4498806,42383,98.79,16351,20224,22159,40085,2051,96,121,30,174,2583,7791,25936,6073,17616,1265,12448,3903,45600,192
TN ED,Meigs,Tennessee,47121,-84.8233223,35.52023315,8033,42.5,2996,4044,3989,7884,118,28,2,1,17,461,1536,5051,985,3689,693,2393,603,44200,183
TN ED,Monroe,Tennessee,47123,-84.23469162,35.44134903,30541,47.13,11363,14839,15702,29561,833,48,71,28,123,1958,5773,18621,4189,12803,1440,9052,2311,40200,180
TN ED,Moore,Tennessee,47127,-86.38102722,35.27506256,4721,36.6,1734,2350,2371,4536,174,8,2,1,20,271,932,2878,640,1912,178,1451,283,50400,214
TN ED,Morgan,Tennessee,47129,-84.62311172,36.14229584,17300,33.08,5841,9112,8188,16957,265,46,25,7,60,1066,3396,10804,2034,6378,537,4844,997,37800,165
TN ED,Polk,Tennessee,47139,-84.53111649,35.1397686,13643,31.15,5092,6725,6918,13571,0,25,42,5,36,787,2507,8385,1964,5659,567,4220,872,37800,170
TN ED,Rhea,Tennessee,47143,-84.92155838,35.62290955,24344,78.78,9185,11748,12596,23571,581,62,53,77,132,1504,4654,14712,3474,10361,1176,6844,2341,45300,207
TN ED,Roane,Tennessee,47145,-84.52412033,35.85319519,47227,132.29,18453,22744,24483,45444,1456,95,191,41,212,2666,8441,29065,7055,20334,1881,14102,4351,48700,194
TN ED,Scott,Tennessee,47151,-84.51397324,36.38690376,18358,34.77,6534,8944,9414,18263,5,67,13,10,38,1281,4100,10777,2200,7122,588,4924,1610,33600,156
TN ED,Sequatchie,Tennessee,47153,-85.42268753,35.36462021,8863,33.32,3287,4383,4480,8851,2,4,5,1,25,572,1714,5491,1086,3570,283,2550,737,39000,183
TN ED,Sevier,Tennessee,47155,-83.51930618,35.80032158,51043,86.51,19520,24838,26205,50462,216,130,203,32,237,3114,9095,32426,6408,24166,4646,14803,4717,62400,254
TN ED,Sullivan,Tennessee,47163,-82.26618195,36.50360107,143596,346.01,56729,68886,74710,140076,2562,372,485,101,521,8402,23852,90841,20501,60623,3894,42530,14199,55600,231
TN ED,Unicoi,Tennessee,47171,-82.4067688,36.10742378,16549,88.97,6621,7915,8634,16488,3,11,14,33,97,872,2725,10112,2840,7076,455,5114,1507,48100,184
TN ED,Union,Tennessee,47173,-83.84489441,36.30063248,13694,62.82,4932,6767,6927,13658,3,23,5,5,38,954,2715,8514,1511,5696,764,3936,996,45500,181
TN ED,Van Buren,Tennessee,47175,-85.42951202,35.69107056,4846,17.75,1799,2398,2448,4823,5,16,0,2,10,317,956,2984,589,2001,202,1507,292,33000,132
TN ED,Warren,Tennessee,47177,-85.77249527,35.68375969,32992,76.55,12681,15900,17092,31511,1131,51,119,180,276,2115,6179,19914,4784,13802,1121,9277,3404,42200,209
TN ED,Washington,Tennessee,47179,-82.49426651,36.27098465,92315,283.17,35823,44658,47657,88409,3275,155,378,98,471,5304,14781,59337,12893,38378,2555,24135,11688,57300,244
TN MD,Cannon,Tennessee,47015,-86.04520035,35.81366158,10467,39.35,3980,5105,5362,10236,186,15,14,16,39,658,1979,6235,1595,4368,388,3157,823,41500,174
TN MD,Cheatham,Tennessee,47021,-87.09248734,36.25502396,27140,89.28,9515,13580,13560,26460,534,84,36,26,139,2086,5520,17262,2272,10297,782,7910,1605,64000,281
TN MD,Clay,Tennessee,47027,-85.53916168,36.51903915,7238,31.89,2855,3567,3671,7103,116,11,3,5,27,391,1283,4390,1174,3340,485,2324,531,37100,141
TN MD,Cumberland,Tennessee,47035,-84.97518158,35.96282005,34736,50.93,13426,16805,17931,34475,42,137,49,33,124,2108,6013,20507,6108,15864,2438,10526,2900,49100,217
TN MD,Davidson,Tennessee,47037,-86.7761116,36.18771172,510784,1019.53,207530,242492,268292,381740,119273,1162,7081,1528,4775,35943,80598,335014,59229,229064,21534,111691,95839,76000,359
TN MD,De Kalb,Tennessee,47041,-85.84338379,35.9834938,14360,49.35,5696,6854,7506,14074,215,19,12,40,62,869,2593,8620,2278,6694,998,4351,1345,44200,189
TN MD,Dickson,Tennessee,47043,-87.34660339,36.15386581,35061,71.41,13019,17025,18036,33145,1744,68,71,33,177,2611,6965,21102,4383,14149,1130,9854,3165,54100,257
TN MD,Fentress,Tennessee,47049,-84.88537979,36.36242104,14669,29.46,5511,7172,7497,14636,2,10,18,3,39,898,2931,8864,1976,6120,609,4329,1182,32300,139
TN MD,Giles,Tennessee,47055,-87.02343369,35.23075676,25741,42.2,9832,12427,13314,22184,3405,57,61,34,109,1724,4705,15156,4156,10828,996,7175,2657,44600,195
TN MD,Hickman,Tennessee,47081,-87.47113037,35.80827713,16754,27.47,5976,8622,8132,15831,859,40,8,16,67,1062,2957,10400,2335,6662,686,4826,1150,43200,199
TN MD,Houston,Tennessee,47083,-87.74856949,36.27833366,7018,35.09,2683,3402,3616,6725,268,12,5,8,41,420,1271,4079,1248,3085,402,2112,571,35300,170
TN MD,Humphreys,Tennessee,47085,-87.76817322,36.0312252,15795,29.91,6063,7756,8039,15175,551,26,32,11,63,989,2982,9531,2293,7136,1073,4688,1375,43700,198
TN MD,Jackson,Tennessee,47087,-85.66748047,36.36985207,9297,30.19,3642,4525,4772,9247,7,19,19,5,38,517,1597,5585,1598,4219,577,2971,671,38000,137
TN MD,Lawrence,Tennessee,47099,-87.40338898,35.23724174,35303,57.22,13338,16949,18354,34666,482,59,73,23,145,2553,6662,20882,5206,14229,891,10213,3125,43300,176
TN MD,Lewis,Tennessee,47101,-87.49362946,35.53388786,9247,32.79,3533,4520,4727,9082,119,26,7,13,54,621,1858,5372,1396,3943,410,2678,855,37200,158
TN MD,Macon,Tennessee,47111,-86.0039444,36.52975082,15906,51.81,6159,7736,8170,15810,44,35,10,7,39,1083,2941,9577,2305,6879,720,4853,1306,36600,170
TN MD,Marshall,Tennessee,47117,-86.77315521,35.49240685,21539,57.28,8268,10408,11131,19536,1909,24,53,17,92,1374,4080,12818,3267,8909,641,5851,2417,47900,228
TN MD,Maury,Tennessee,47119,-87.06507111,35.63911438,54812,88.98,20608,26245,28567,45868,8607,79,157,101,323,3875,10403,33280,7254,22286,1678,14225,6383,60700,284
TN MD,Montgomery,Tennessee,47125,-87.37667084,36.48645592,100498,186.45,34345,51503,48995,79118,17872,394,1831,1283,3228,8681,17952,65894,7971,37233,2888,20983,13362,58100,298
TN MD,Overton,Tennessee,47133,-85.28388977,36.34692574,17636,40.73,6734,8669,8967,17582,30,10,4,10,73,1018,3224,10675,2719,7388,654,5409,1325,36700,154
TN MD,Pickett,Tennessee,47137,-85.13894664,36.51888084,4548,28.6,1786,2223,2325,4542,0,4,2,0,13,294,823,2658,773,2253,467,1407,379,34200,99
TN MD,Putnam,Tennessee,47141,-85.45121384,36.1472702,51373,128.75,19753,25197,26176,49878,873,79,457,86,294,3060,8185,33465,6663,21417,1664,13187,6566,55000,230
TN MD,Robertson,Tennessee,47147,-86.82453918,36.50096893,41494,87.17,14801,20323,21171,36802,4555,63,43,31,173,3167,8218,25054,5055,15823,1022,11085,3716,61300,240
TN MD,Rutherford,Tennessee,47149,-86.41333008,35.85943031,118570,195.66,42118,58373,60197,105740,10678,234,1706,212,926,8934,22839,76786,10011,45755,3637,27826,14292,71800,333
TN MD,Smith,Tennessee,47159,-85.95521545,36.25973892,14143,45.19,5358,6842,7301,13626,459,36,13,9,48,941,2598,8356,2248,6049,691,4223,1135,45900,175
TN MD,Stewart,Tennessee,47161,-87.83050156,36.50527,9479,20.88,3678,4675,4804,9294,96,56,26,7,48,484,1622,5724,1649,4384,706,3032,646,43700,156
TN MD,Sumner,Tennessee,47165,-86.47517395,36.4491806,103281,195.24,36850,50567,52714,97073,5562,195,347,104,567,7252,21196,64368,10465,39807,2957,27641,9209,73900,339
TN MD,Trousdale,Tennessee,47169,-86.12644196,36.39605331,5920,51.93,2261,2873,3047,5040,853,14,8,5,31,342,1079,3506,993,2537,276,1690,571,41900,187
TN MD,Wayne,Tennessee,47181,-87.79915237,35.25681305,13935,18.99,5174,6822,7113,13762,137,17,10,9,52,914,2662,8305,2054,5741,567,4328,846,32800,145
TN MD,White,Tennessee,47185,-85.43934631,35.94311523,20090,53.86,7722,9710,10380,19654,378,24,25,9,74,1239,3565,12050,3236,8369,647,6295,1427,40300,180
TN MD,Williamson,Tennessee,47187,-86.91004181,35.87992668,81021,138.73,27928,39817,41204,74903,5396,130,469,123,522,6033,17525,50776,6687,29875,1947,22210,5718,131100,407
TN MD,Wilson,Tennessee,47189,-86.29407883,36.15329361,67675,118.73,24070,33417,34258,62561,4607,185,259,63,386,4865,13674,42527,6609,26198,2128,19379,4691,82000,310
TN WD,Benton,Tennessee,47005,-88.06507492,36.08838463,14524,37.05,5784,6879,7645,14109,345,23,31,16,72,811,2529,8587,2597,7107,1323,4638,1146,39700,169
TN WD,Carroll,Tennessee,47017,-88.43992615,35.97327614,27514,45.86,10727,13221,14293,24303,3138,35,10,28,125,1707,4824,16037,4946,11783,1056,8477,2250,35700,170
TN WD,Chester,Tennessee,47023,-88.60766602,35.42322731,12819,44.36,4558,6123,6696,11355,1412,20,22,10,53,819,2195,7888,1917,4944,386,3529,1029,40200,164
TN WD,Crockett,Tennessee,47033,-89.13197708,35.83492661,13378,50.29,5183,6369,7009,11097,2252,9,9,11,49,839,2418,7580,2541,5521,338,3959,1224,38600,156
TN WD,Decatur,Tennessee,47039,-88.10427475,35.62055969,10472,31.73,4216,5045,5427,10000,417,23,21,11,49,543,1849,6100,1980,5346,1130,3395,821,34700,150
TN WD,Dyer,Tennessee,47045,-89.4389801,36.04720116,34854,67.03,13617,16504,18350,30541,4145,64,63,41,137,2326,6581,20739,5208,14384,767,8965,4652,44100,212
TN WD,Fayette,Tennessee,47047,-89.41669083,35.20290947,25559,36.25,8453,12449,13110,14204,11295,33,15,12,130,1996,5645,14598,3320,9115,662,6327,2126,51400,137
TN WD,Gibson,Tennessee,47053,-88.9463501,36.01151085,46315,76.94,18361,21714,24601,37237,8944,37,61,36,181,2850,8201,26748,8516,19635,1274,13332,5029,39200,177
TN WD,Hardeman,Tennessee,47069,-88.99152756,35.21789742,23377,34.89,8276,11239,12138,14536,8748,20,62,11,175,1772,4849,13417,3339,9174,898,6094,2182,39200,163
TN WD,Hardin,Tennessee,47071,-88.18368912,35.21678734,22633,39.16,8726,10923,11710,21539,997,34,37,26,87,1435,4217,13467,3514,10275,1549,6750,1976,39100,165
TN WD,Haywood,Tennessee,47075,-89.28905487,35.6098671,19437,36.4,7014,9106,10331,9676,9651,24,19,67,156,1367,4271,10793,3006,7475,461,4659,2355,40400,174
TN WD,Henderson,Tennessee,47077,-88.39113235,35.62443352,21844,42.01,8527,10512,11332,19982,1816,20,19,7,100,1352,4100,13094,3298,9278,751,6799,1728,42200,174
TN WD,Henry,Tennessee,47079,-88.25949097,36.31546974,27888,49.8,11362,13370,14518,24955,2813,50,54,16,110,1594,4777,16033,5484,13774,2412,8692,2670,41700,176
TN WD,Lake,Tennessee,47095,-89.51885605,36.3431797,7129,42.18,2418,3808,3321,5418,1702,4,2,3,27,399,1166,4509,1055,2610,192,1413,1005,35100,119
TN WD,Lauderdale,Tennessee,47097,-89.64982224,35.7494812,23491,49.56,8423,11376,12115,16007,7303,127,20,34,178,1686,4717,13564,3524,9343,920,5636,2787,38700,183
TN WD,Madison,Tennessee,47113,-88.83683014,35.61694717,77982,139.75,29609,36746,41236,53423,24170,66,253,70,376,5508,14817,46894,10763,31809,2200,19359,10250,53500,242
TN WD,McNairy,Tennessee,47109,-88.57503891,35.19565582,22422,39.9,8834,10819,11603,20918,1432,21,40,11,95,1331,4172,13304,3615,9734,900,6993,1841,36400,159
TN WD,Obion,Tennessee,47131,-89.14157867,36.35209084,31717,57.67,12412,15161,16556,28324,3256,47,48,42,138,1853,5984,18944,4936,13359,947,8762,3650,43500,194
TN WD,Perry,Tennessee,47135,-87.84619904,35.63828278,6612,16.05,2512,3247,3365,6470,119,8,7,8,36,459,1201,3857,1095,3225,713,2107,405,35600,158
TN WD,Shelby,Tennessee,47157,-89.96912384,35.23868752,826330,1070.38,303571,393614,432716,455063,360083,1468,7740,1976,7091,66545,159762,513688,86335,327796,24225,180490,123081,66500,302
TN WD,Tipton,Tennessee,47167,-89.75615311,35.51372528,37568,82.75,13033,18331,19237,28436,8852,114,100,66,253,3214,8273,22024,4057,14071,1038,9376,3657,56100,215
TN WD,Weakley,Tennessee,47183,-88.73456192,36.28375435,31972,55.03,11992,15312,16660,29368,2222,39,277,66,128,1829,5208,19796,5139,12857,865,8453,3539,39800,184
TX ED,Anderson,Texas,48001,-95.65938187,31.7999754,48024,44.59,14223,27821,20203,33354,11143,129,125,3273,3953,2993,8287,30648,6096,16909,2686,10354,3869,42800,275
TX ED,Angelina,Texas,48005,-94.56949234,31.28136253,69884,86.6,25004,33867,36017,54752,10731,153,295,3953,6072,5289,14726,40790,9079,28796,3792,17893,7111,43600,252
TX ED,Bowie,Texas,48037,-94.39051819,33.4745903,81665,91.66,30595,39477,42188,62878,17798,412,262,315,1334,5729,16465,47725,11746,34234,3639,21660,8935,48100,263
TX ED,Camp,Texas,48063,-94.94015884,32.99620438,9904,48.79,3773,4753,5151,7130,2360,35,5,374,501,661,1946,5536,1761,4530,757,2802,971,42200,218
TX ED,Cass,Texas,48067,-94.34864426,33.09598351,29982,32,11320,14384,15598,23651,6057,105,25,144,373,1989,6208,16651,5134,13191,1871,8806,2514,38700,177
TX ED,Cherokee,Texas,48073,-95.16843414,31.79083252,41049,39.02,14981,20184,20865,32039,6931,108,196,1775,2697,2903,7856,23118,7172,17629,2648,10886,4095,39500,213
TX ED,Collin,Texas,48085,-96.56247711,33.19582939,264036,310.27,95805,131287,132749,235290,10925,1112,7480,9229,18158,22329,54173,173765,13769,103827,8022,63849,31956,106600,451
TX ED,Cooke,Texas,48097,-97.20703506,33.68647766,30777,34.46,11545,15073,15704,28375,1169,232,131,870,1408,2314,6395,17187,4881,13315,1770,8248,3297,47700,243
TX ED,Delta,Texas,48119,-95.57857513,33.36013031,4857,17.47,1901,2306,2551,4388,404,41,7,17,67,305,872,2534,1146,2305,404,1445,456,30300,160
TX ED,Denton,Texas,48121,-97.11006927,33.21231079,273525,300.25,101984,135145,138380,241982,13569,1416,6870,9688,19013,23453,50192,186105,13775,112263,10279,58588,43396,89100,402
TX ED,Fannin,Texas,48147,-96.11118698,33.61547661,24804,27.71,9691,11971,12833,22722,1633,182,54,213,485,1574,4398,13632,5200,11504,1813,7357,2334,35100,202
TX ED,Franklin,Texas,48159,-95.21317291,33.1798172,7802,26.54,3017,3782,4020,7139,349,47,18,249,357,531,1456,4349,1466,4219,1202,2300,717,46800,205
TX ED,Grayson,Texas,48181,-96.65435028,33.67946625,95021,101.74,36847,45339,49682,85553,6565,1046,412,1445,2795,6459,17649,55400,15513,44223,7376,25541,11306,46600,277
TX ED,Gregg,Texas,48183,-94.78178024,32.51263618,104948,384.42,40027,50339,54609,81883,19937,478,491,2159,3775,8004,20717,62302,13925,44689,4662,25292,14735,56000,269
TX ED,Hardin,Texas,48199,-94.39844131,30.31150532,41320,46.01,14693,20279,21041,37485,3485,123,58,169,679,2978,9136,24346,4860,16486,1793,11834,2859,48300,243
TX ED,Harrison,Texas,48203,-94.36988449,32.56175804,57483,63.31,20705,27626,29857,40387,16038,192,144,722,1278,4096,12459,33143,7785,23481,2776,15590,5115,46000,235
TX ED,Henderson,Texas,48213,-95.93968582,32.18990326,58543,65.93,22947,28386,30157,52216,4755,181,141,1250,2368,3680,10382,33236,11245,31779,8832,18155,4792,53600,245
TX ED,Hopkins,Texas,48223,-95.58323288,33.17523575,28833,36.54,10965,14133,14700,25381,2476,126,70,780,1407,2082,5579,16482,4690,12676,1711,7762,3203,43600,247
TX ED,Houston,Texas,48225,-95.37013245,31.26658821,21375,17.32,7792,10844,10531,14373,6326,32,49,595,965,1378,4006,11885,4106,10265,2473,5801,1991,40000,168
TX ED,Jasper,Texas,48241,-94.0003746,30.70085716,31102,33.77,11427,14865,16237,24750,5868,76,38,370,594,2091,6718,17256,5037,13824,2397,9037,2390,40300,200
TX ED,Jefferson,Texas,48245,-94.14332199,29.87369442,239397,255.49,90520,114849,124548,154273,74412,578,5145,4989,12629,17628,47062,141073,33634,101289,10769,59715,30805,41800,268
TX ED,Lamar,Texas,48277,-95.57665253,33.66378021,43949,47.82,16798,20820,23129,36814,6397,406,153,179,475,3140,8299,24849,7661,18964,2166,11567,5231,39000,253
TX ED,Liberty,Texas,48291,-94.80641556,30.18880081,52726,44.91,18538,26321,26405,44014,6911,181,124,1496,2880,3913,11490,31131,6192,22243,3705,13990,4548,42100,245
TX ED,Marion,Texas,48315,-94.37303162,32.78764534,9984,25.93,4048,4915,5069,6792,3100,44,7,41,147,638,1833,5552,1961,5729,1681,3278,770,34500,176
TX ED,Morris,Texas,48343,-94.73701859,33.13285828,13200,51.56,4988,6363,6837,9770,3227,70,18,115,239,890,2733,7344,2233,5800,812,3786,1202,35300,184
TX ED,Nacogdoches,Texas,48347,-94.64477921,31.53719044,54753,58.31,20124,26507,28246,43772,9020,144,311,1506,2788,3515,9169,35599,6470,22768,2644,11699,8425,54100,276
TX ED,Newton,Texas,48351,-93.7124939,30.71515083,13569,14.51,4910,6615,6954,10402,3039,44,11,73,153,954,3055,7732,1828,6378,1468,4086,824,30500,157
TX ED,Orange,Texas,48361,-93.89832687,30.10396385,80509,222.4,29025,39374,41135,72607,6768,189,484,461,1933,5793,17208,48768,8740,32032,3007,21951,7074,44400,254
TX ED,Panola,Texas,48365,-94.30231094,32.1803503,22035,27.14,8241,10537,11498,17702,4057,57,23,196,477,1526,4613,12413,3483,9700,1459,6625,1616,43100,228
TX ED,Polk,Texas,48373,-94.86860275,30.81913948,30687,28.92,11855,14963,15724,25100,3896,662,78,951,1610,1967,5637,16802,6281,18662,6807,9516,2339,39900,218
TX ED,Rains,Texas,48379,-95.79987335,32.85370636,6715,27.63,2609,3300,3415,6310,286,29,8,82,158,394,1290,3817,1214,3533,924,2129,480,42500,203
TX ED,Red River,Texas,48387,-95.02180481,33.64712143,14317,13.58,5688,6733,7584,11203,2872,75,14,153,273,836,2607,7749,3125,6650,962,4299,1389,25700,130
TX ED,Rusk,Texas,48401,-94.72372437,32.12677288,43735,46.93,16327,20931,22804,33730,8984,150,51,820,1736,3042,9126,24033,7534,19092,2765,12901,3426,41800,220
TX ED,Sabine,Texas,48403,-93.82321548,31.37462425,9586,19.72,3985,4620,4966,8394,1117,10,12,53,111,524,1490,5133,2439,6996,3011,3367,618,36200,147
TX ED,San Augustine,Texas,48405,-94.19143677,31.3774519,7999,15.27,3073,3774,4225,5663,2244,15,6,71,138,519,1434,4259,1787,4168,1095,2435,638,35200,136
TX ED,Shelby,Texas,48419,-94.15016174,31.77353096,22034,27.86,8476,10463,11571,17047,4727,36,31,193,539,1562,4203,12017,4252,10616,2140,6583,1893,35200,161
TX ED,Smith,Texas,48423,-95.28995895,32.41532326,151309,162.35,56800,72774,78535,113676,31572,520,638,4903,8986,11128,29155,90193,20833,64369,7569,37785,19015,59900,296
TX ED,Titus,Texas,48449,-94.97083282,33.1937542,24009,58.27,8508,11685,12324,18664,3229,107,27,1982,2556,2010,4842,13422,3735,9357,849,6149,2359,44400,256
TX ED,Trinity,Texas,48455,-95.13312912,31.10677242,11445,16.54,4647,5534,5911,9619,1645,24,21,136,272,710,1970,6264,2501,7200,2553,3665,982,38700,191
TX ED,Tyler,Texas,48457,-94.3537941,30.79332733,16646,18.05,6459,8090,8556,14550,1994,46,12,44,177,977,3176,9130,3363,9047,2588,5362,1097,37900,210
TX ED,Upshur,Texas,48459,-94.92449951,32.7203083,31370,53.44,11360,15229,16141,27076,3881,121,29,263,641,2242,6424,18123,4581,12887,1527,9134,2226,42100,209
TX ED,Van Zandt,Texas,48467,-95.76383972,32.60443306,37944,44.38,14349,18500,19444,35351,1451,155,47,940,1515,2437,7284,21446,6777,17013,2664,11552,2797,45600,239
TX ED,Wood,Texas,48499,-95.4046669,32.77902412,29380,42.64,11426,14119,15261,26363,2402,109,40,466,788,1711,5352,16140,6177,14541,3115,9096,2330,47400,221
TX ND,Archer,Texas,48009,-98.68431473,33.61602211,7973,8.79,2957,3981,3992,7789,11,36,4,133,189,570,1662,4627,1114,3680,723,2376,581,45200,213
TX ND,Armstrong,Texas,48011,-101.3576889,34.96539879,2021,2.22,768,978,1043,1976,0,10,7,28,55,124,438,1019,440,916,148,620,148,43700,213
TX ND,Bailey,Texas,48017,-102.8192253,34.06712723,7064,8.55,2454,3499,3565,6537,124,10,12,381,2740,564,1686,3844,970,3109,655,1710,744,35300,201
TX ND,Baylor,Texas,48023,-99.21183014,33.61576462,4385,5.09,1906,2072,2313,3962,180,9,13,221,334,278,701,2263,1143,3006,1100,1340,566,34000,144
TX ND,Borden,Texas,48033,-101.4315682,32.73953247,799,0.89,294,410,389,769,2,10,0,18,120,57,167,462,113,478,184,203,91,22800,125
TX ND,Briscoe,Texas,48045,-101.2068977,34.52964783,1971,2.22,789,977,994,1559,68,5,0,339,367,129,422,1011,409,1074,285,603,186,22400,164
TX ND,Brown,Texas,48049,-98.93792725,31.76780796,34371,36.72,13097,16659,17712,30267,1552,131,88,2333,3799,2378,6859,19057,6077,16909,3812,9403,3694,36500,236
TX ND,Callahan,Texas,48059,-99.37084961,32.30294418,11859,13.19,4565,5734,6125,11482,2,44,40,291,489,787,2471,6559,2042,5503,938,3697,868,35500,211
TX ND,Carson,Texas,48065,-101.3558159,35.4035511,6576,7.12,2402,3190,3386,6315,11,44,9,197,354,466,1501,3593,1016,2856,454,1950,452,40200,237
TX ND,Castro,Texas,48069,-102.257061,34.53077316,9070,10.09,2877,4504,4566,5526,261,10,15,3258,4187,863,2433,4865,909,3357,480,1916,961,39900,209
TX ND,Childress,Texas,48075,-100.208313,34.52981186,5953,8.42,2435,2768,3185,4969,321,26,17,620,853,340,1213,3050,1350,3046,611,1799,636,31100,170
TX ND,Clay,Texas,48077,-98.18454742,33.80925941,10024,9.23,3808,4880,5144,9751,33,88,23,129,242,633,2008,5677,1706,4708,900,3148,660,37500,194
TX ND,Cochran,Texas,48079,-102.8150826,33.60404587,4377,5.65,1430,2169,2208,2997,234,13,1,1132,1857,367,1092,2369,549,1763,333,1039,391,22400,161
TX ND,Coke,Texas,48081,-100.5287552,31.89271259,3424,3.77,1374,1634,1790,3222,6,17,2,177,422,182,610,1756,876,2793,1419,1056,318,37300,144
TX ND,Coleman,Texas,48083,-99.45824432,31.74930668,9710,7.6,4026,4602,5108,8995,246,29,7,433,1139,645,1683,4885,2497,5382,1356,2945,1081,26300,152
TX ND,Collingsworth,Texas,48087,-100.2704468,34.96408272,3573,3.93,1447,1719,1854,2977,230,32,3,331,561,235,716,1774,848,1952,505,1141,306,25100,156
TX ND,Comanche,Texas,48093,-98.54108047,31.97575378,13381,14.39,5318,6549,6832,12297,16,51,8,1009,2205,858,2281,7094,3148,6724,1406,4111,1207,31700,160
TX ND,Concho,Texas,48095,-99.85693359,31.33652878,3044,3.07,1063,1653,1391,2718,16,5,5,300,1194,165,535,1754,590,1514,451,750,313,34300,147
TX ND,Cottle,Texas,48101,-100.2620544,34.07783699,2247,2.51,915,1094,1153,1853,199,4,3,188,367,132,446,1126,543,1286,371,660,255,25700,120
TX ND,Crockett,Texas,48105,-101.6706276,30.68689823,4078,1.45,1449,2065,2013,4018,39,9,4,8,2021,341,915,2343,479,1897,448,974,475,43100,174
TX ND,Crosby,Texas,48107,-101.3037148,33.61329651,7304,8.12,2516,3538,3766,5784,321,13,8,1178,3111,586,1696,3855,1167,3312,796,1784,732,29700,157
TX ND,Dallam,Texas,48111,-102.5960121,36.27348518,5461,3.63,2122,2657,2804,4600,112,43,14,692,1151,458,1202,3006,795,2577,455,1457,665,28100,222
TX ND,Dallas,Texas,48113,-96.77435684,32.77393532,1852810,2105.47,701686,911686,941124,1241455,369597,9437,52238,180083,315630,156059,339589,1204648,152514,795513,93827,362781,338905,79200,389
TX ND,Dawson,Texas,48115,-101.9457817,32.73924065,14349,15.89,5084,6949,7400,9789,622,23,19,3896,6120,1146,3396,7580,2227,5969,885,3732,1352,34200,207
TX ND,Deaf Smith,Texas,48117,-102.5941048,34.96310234,19153,12.79,6182,9487,9666,14522,307,49,39,4236,9356,1831,4935,10316,2071,7152,970,4096,2086,41700,239
TX ND,Dickens,Texas,48125,-100.7824669,33.615242,2571,2.83,1073,1222,1349,2193,113,13,1,251,479,139,472,1309,651,1564,491,813,260,19100,110
TX ND,Donley,Texas,48129,-100.8120575,34.96434784,3696,3.98,1515,1765,1931,3522,127,13,2,32,139,182,619,1950,945,2304,789,1105,410,31000,175
TX ND,Eastland,Texas,48133,-98.79500198,32.30248451,18488,20.01,7354,8883,9605,17474,397,52,37,528,1404,1034,3269,9945,4240,9768,2414,5465,1889,27800,176
TX ND,Ellis,Texas,48139,-96.74324036,32.31175041,85167,90.7,28588,42025,43142,69049,8525,370,214,7009,11243,7165,19237,50156,8609,31314,2726,20731,7857,67900,320
TX ND,Erath,Texas,48143,-98.20830154,32.21973228,27991,25.92,10877,13764,14227,26413,195,94,115,1174,2458,1950,4747,16916,4378,12758,1881,6819,4058,48600,256
TX ND,Fisher,Texas,48151,-100.4060173,32.73944664,4842,5.4,1892,2340,2502,4445,190,19,0,188,997,292,960,2552,1038,2413,521,1445,447,26500,137
TX ND,Floyd,Texas,48153,-101.3041954,34.07367516,8497,8.57,2982,4117,4380,5523,320,16,15,2623,3381,742,1944,4411,1400,3535,553,2080,902,29200,172
TX ND,Foard,Texas,48155,-99.76428986,33.98524094,1794,2.55,739,827,967,1552,88,11,4,139,233,111,318,911,454,890,151,532,207,20700,151
TX ND,Gaines,Texas,48165,-102.6273308,32.7348423,14123,9.39,4502,7066,7057,10378,334,38,15,3358,4608,1412,3729,7687,1295,5221,719,3248,1254,39800,216
TX ND,Garza,Texas,48169,-101.301899,33.17224693,5143,5.75,1822,2467,2676,4588,328,9,21,197,1454,404,1224,2685,830,2184,362,1300,522,31300,155
TX ND,Glasscock,Texas,48173,-101.5204582,31.87139893,1447,1.61,456,740,707,1156,0,2,0,289,424,143,368,849,87,600,144,274,182,47500,100
TX ND,Gray,Texas,48179,-100.8117561,35.40348816,23967,26.02,9548,11497,12470,21566,899,216,115,1171,1895,1612,4725,13468,4162,11532,1984,7222,2326,35500,244
TX ND,Hale,Texas,48189,-101.8236427,34.07182312,34671,34.5,11703,16989,17682,23823,1852,148,136,8712,14428,3139,8025,19208,4299,13168,1465,7301,4402,39000,241
TX ND,Hall,Texas,48191,-100.6825867,34.53051186,3905,4.45,1669,1832,2073,2908,303,15,7,672,727,226,701,1946,1032,2189,520,1247,422,21400,145
TX ND,Hansford,Texas,48195,-101.3513145,36.27335739,5848,6.35,2112,2913,2935,4821,0,23,14,990,1174,450,1370,3277,751,2525,413,1565,547,43800,235
TX ND,Hardeman,Texas,48197,-99.73714447,34.32061195,5283,7.68,2101,2504,2779,4427,321,26,16,493,589,358,1021,2684,1220,2678,577,1583,518,25500,170
TX ND,Hartley,Texas,48205,-102.5919991,35.83981514,3634,2.49,1332,1746,1888,3510,9,30,7,78,201,234,819,2012,569,1541,209,1030,302,60600,258
TX ND,Haskell,Texas,48207,-99.72690964,33.17907143,6820,7.57,2753,3282,3538,5481,244,17,16,1062,1312,431,1272,3439,1678,3843,1090,2097,656,28200,152
TX ND,Hemphill,Texas,48211,-100.2701683,35.83847237,3720,4.12,1348,1816,1904,3503,7,22,5,183,412,277,873,2077,493,1712,364,991,357,47500,241
TX ND,Hockley,Texas,48219,-102.3393936,33.60817528,24199,26.65,7988,11942,12257,18937,1023,86,33,4120,7654,2067,5746,13807,2579,9279,1291,5802,2186,41900,233
TX ND,Hood,Texas,48221,-97.83831024,32.39902496,28981,68.19,11137,14385,14596,28054,52,154,177,544,1353,1969,5433,16911,4668,14958,3821,8812,2325,73800,333
TX ND,Howard,Texas,48227,-101.4334145,32.30676079,32343,35.9,11477,16288,16055,25282,1225,179,162,5495,8607,2454,6263,18939,4687,13651,2174,8113,3364,34900,250
TX ND,Hunt,Texas,48231,-96.07318115,33.1286087,64343,76.6,24075,31435,32908,55705,6802,266,351,1219,2876,4758,12247,38285,9053,28959,4884,16863,7212,47300,288
TX ND,Hutchinson,Texas,48233,-101.3522873,35.84045792,25689,29.46,9642,12680,13009,22661,677,362,105,1884,2509,1843,5630,14367,3849,11419,1777,7469,2173,38200,239
TX ND,Irion,Texas,48235,-100.9811478,31.30912495,1629,1.55,601,811,818,1609,2,1,0,17,385,132,330,952,215,842,241,445,156,44600,199
TX ND,Jack,Texas,48237,-98.16815948,33.2363987,6981,7.59,2725,3404,3577,6748,51,18,10,154,232,488,1383,3798,1312,3497,772,2096,629,33800,170
TX ND,Johnson,Texas,48251,-97.35116196,32.3519783,97165,133.1,33462,48152,49013,90328,2521,419,447,3450,7457,7490,20846,58743,10086,37029,3567,25483,7979,61100,311
TX ND,Jones,Texas,48253,-99.87820816,32.73910713,16490,17.71,6180,7889,8601,13786,666,47,31,1960,2786,1107,3444,8824,3115,7639,1459,4828,1352,29600,176
TX ND,Kaufman,Texas,48257,-96.30405807,32.60595703,52220,66.27,17827,25530,26690,42810,7295,198,229,1688,3340,4026,11336,30667,6191,20097,2270,13604,4223,56600,282
TX ND,Kent,Texas,48263,-100.7819862,33.17558289,1010,1.15,399,485,525,902,6,1,0,101,120,67,194,532,217,603,204,297,102,28100,143
TX ND,King,Texas,48269,-100.257122,33.61629677,354,0.39,124,183,171,317,0,0,0,37,53,24,85,223,22,191,67,44,80,17500,150
TX ND,Knox,Texas,48275,-99.73363495,33.61432648,4837,5.72,1887,2328,2509,3765,338,7,5,722,1088,359,971,2434,1073,2459,572,1435,452,27600,133
TX ND,Lamb,Texas,48279,-102.3452377,34.06955338,15072,14.88,5488,7280,7792,13036,822,88,25,1101,5509,1121,3393,7873,2685,6531,1043,4031,1457,28900,185
TX ND,Lipscomb,Texas,48295,-100.2732849,36.27571297,3143,3.37,1230,1580,1563,3092,1,34,13,3,379,218,697,1714,514,1683,453,950,280,35500,198
TX ND,Lubbock,Texas,48303,-101.8216667,33.6122551,222636,247.37,81534,109658,112978,176037,17154,686,2722,26037,51011,17052,41813,141784,21987,91770,10236,47438,34096,54500,311
TX ND,Lynn,Texas,48305,-101.8167191,33.17269897,6758,7.61,2383,3321,3437,5214,223,22,11,1288,2819,556,1496,3668,1038,2978,595,1693,690,31900,161
TX ND,Menard,Texas,48327,-99.79777145,30.89980698,2252,2.5,937,1114,1138,2076,7,5,0,164,726,155,394,1169,534,1562,625,690,247,25700,163
TX ND,Mills,Texas,48333,-98.62507629,31.48107815,4531,6.06,1782,2202,2329,4238,10,4,1,278,484,257,826,2239,1209,2582,800,1413,369,34100,136
TX ND,Mitchell,Texas,48335,-100.9207993,32.30413246,8016,8.79,3054,3823,4193,6317,363,14,5,1317,2389,522,1681,4134,1679,4559,1505,2323,731,25700,169
TX ND,Montague,Texas,48337,-97.728405,33.71160316,17274,18.61,6858,8281,8993,16834,5,72,13,350,548,1124,3122,9235,3793,9262,2404,5357,1501,35000,181
TX ND,Moore,Texas,48341,-101.8935356,35.83984566,17865,19.74,6101,8941,8924,12789,95,123,282,4576,5693,1689,4213,10196,1767,6837,736,4236,1865,46400,251
TX ND,Motley,Texas,48345,-100.783474,34.07611084,1532,1.6,647,741,791,1362,68,5,4,93,136,84,273,773,402,1026,379,496,151,23700,119
TX ND,Navarro,Texas,48349,-96.47384644,32.06930256,39926,37.38,14874,19193,20733,30322,7574,127,271,1632,2891,2976,7782,22305,6863,17219,2345,10334,4540,40900,248
TX ND,Nolan,Texas,48353,-100.4103088,32.30301666,16594,18.14,6183,8066,8528,12942,775,46,18,2813,4246,1232,3386,9234,2742,7462,1279,4352,1831,29300,196
TX ND,Ochiltree,Texas,48357,-100.8151321,36.27293587,9128,9.93,3328,4562,4566,8023,2,105,8,990,1641,757,2065,5311,995,3996,668,2376,952,45400,266
TX ND,Oldham,Texas,48359,-102.5884819,35.40109444,2278,1.53,681,1288,990,2112,9,29,18,110,200,136,804,1098,240,861,180,442,239,42100,242
TX ND,Palo Pinto,Texas,48363,-98.31342316,32.76313782,25055,26.4,9531,12100,12955,22810,792,87,171,1195,2301,1827,4783,14181,4264,13349,3818,6907,2624,37400,222
TX ND,Parker,Texas,48367,-97.80002213,32.7790699,64785,71.82,23048,32389,32396,62267,589,367,231,1331,2697,4816,13328,39546,7095,26044,2996,18215,4833,67600,302
TX ND,Parmer,Texas,48369,-102.7733994,34.53050423,9863,11.14,3241,4964,4899,8980,123,29,24,707,4096,897,2365,5370,1231,3685,444,2266,975,39100,223
TX ND,Potter,Texas,48375,-101.8913498,35.40327454,97874,108.51,37344,47044,50830,73884,8673,901,2570,11846,19246,8742,19398,56928,12806,42927,5583,22490,14854,39100,274
TX ND,Randall,Texas,48381,-101.897644,34.96559525,89673,97.79,34553,43230,46443,84633,1115,454,646,2825,6144,6566,17938,56266,8903,37807,3254,23642,10911,64800,318
TX ND,Reagan,Texas,48383,-101.5210762,31.37003803,4514,3.85,1358,2287,2227,3550,127,7,1,829,1941,451,1265,2458,340,1685,327,992,366,44000,236
TX ND,Roberts,Texas,48393,-100.8171616,35.84139442,1025,1.12,391,500,525,1002,0,1,2,20,34,70,237,601,117,492,101,281,110,42200,191
TX ND,Rockwall,Texas,48397,-96.4046936,32.90590286,25604,200.03,8838,12722,12882,23991,855,102,164,492,1500,1953,5569,16106,1976,9816,978,6840,1998,97900,428
TX ND,Runnels,Texas,48399,-99.97241974,31.83096313,11294,10.7,4346,5503,5791,10438,183,16,16,641,2740,781,2307,5867,2339,5345,999,3292,1054,30300,169
TX ND,Schleicher,Texas,48413,-100.5375671,30.89203644,2990,2.28,1051,1446,1544,2078,27,3,1,881,1062,237,736,1556,461,1288,237,752,299,33300,181
TX ND,Scurry,Texas,48415,-100.9185219,32.73944855,18634,20.7,6368,9513,9121,14113,879,62,35,3545,4454,1345,3970,10845,2474,7702,1334,4666,1702,38100,230
TX ND,Shackelford,Texas,48417,-99.35596466,32.73973274,3316,3.62,1336,1613,1703,3125,12,9,2,168,272,208,680,1748,680,1755,419,1008,328,32800,177
TX ND,Sherman,Texas,48421,-101.8935356,36.27379036,2858,3.1,1053,1424,1434,2816,4,12,7,19,538,215,621,1633,389,1293,240,738,315,36900,215
TX ND,Stephens,Texas,48429,-98.83255005,32.73835945,9010,10.08,3556,4317,4693,8187,252,30,28,513,767,616,1844,4818,1732,4982,1426,2660,896,35900,199
TX ND,Sterling,Texas,48431,-101.0430641,31.8294487,1438,1.56,494,702,736,1244,0,9,0,185,366,126,357,778,177,623,129,342,152,48100,197
TX ND,Stonewall,Texas,48433,-100.2552795,33.17635918,2013,2.18,806,975,1038,1898,89,2,7,17,237,137,375,1084,417,1085,279,620,186,29600,147
TX ND,Sutton,Texas,48435,-100.5371475,30.49346447,4135,2.84,1466,2001,2134,3125,2,16,6,986,1866,318,951,2433,433,1924,458,990,476,39500,209
TX ND,Swisher,Texas,48437,-101.7311707,34.53095055,8133,9.02,2993,4001,4132,5702,340,26,17,2048,2496,676,1782,4319,1356,3497,504,2047,946,34200,193
TX ND,Tarrant,Texas,48439,-97.28696823,32.77753639,1170103,1348.04,438634,578780,591323,917501,140740,5551,29705,76606,139879,100035,217486,755158,97424,491152,52518,254907,183727,72900,364
TX ND,Taylor,Texas,48441,-99.89165115,32.30418205,119655,130.49,43301,58202,61453,100237,7547,450,1449,9972,17511,9809,22793,72665,14388,49988,6687,26924,16377,45500,289
TX ND,Throckmorton,Texas,48447,-99.21016693,33.17705345,1880,2.06,790,906,974,1778,0,4,8,90,136,123,322,1011,424,1106,316,602,188,28700,142
TX ND,Tom Green,Texas,48451,-100.4018886,31.39410686,98458,64.99,35408,47722,50736,79533,4136,373,998,13418,25501,7643,18975,59307,12533,40135,4727,22049,13359,49600,300
TX ND,Wheeler,Texas,48483,-100.2687683,35.40357399,5879,6.5,2350,2791,3088,5424,154,42,23,236,378,350,1217,3031,1281,3071,721,1844,506,31200,176
TX ND,Wichita,Texas,48485,-98.68560791,34.01386833,122378,201.94,45271,59946,62432,102427,11221,903,1851,5976,10555,9348,22631,74799,15600,51413,6142,28711,16560,46400,291
TX ND,Wilbarger,Texas,48487,-99.2159729,34.13890457,15121,15.97,5741,7463,7658,12010,1349,80,82,1600,2185,1082,2909,8292,2838,6812,1071,3864,1877,36300,213
TX ND,Wise,Texas,48497,-97.64949799,33.21655846,34679,38.45,12175,17479,17200,32550,390,210,83,1446,2663,2652,7158,20530,4339,14219,2044,9646,2529,49700,244
TX ND,Yoakum,Texas,48501,-102.818531,33.16748047,8786,10.98,2839,4426,4360,6300,86,31,11,2358,3217,758,2303,4961,764,3372,533,2104,735,45100,259
TX ND,Young,Texas,48503,-98.68463898,33.17507553,18126,19.72,7101,8693,9433,17023,268,62,49,724,1164,1303,3521,9987,3315,8523,1422,5193,1908,41200,203
TX SD,Aransas,Texas,48007,-96.86380647,28.21360683,17892,63.9,6938,8868,9024,15282,319,111,589,1591,3588,1201,3305,10075,3311,10889,3951,5071,1867,56700,278
TX SD,Austin,Texas,48015,-96.3234787,29.84987545,19832,30.23,7478,9679,10153,16244,2608,46,26,908,2073,1342,3971,11008,3511,8885,1407,5561,1917,57400,239
TX SD,Bee,Texas,48025,-97.73402405,28.41903877,25135,28.56,8592,12433,12702,19443,727,103,231,4631,12909,2189,5736,14348,2862,10208,1616,5480,3112,39400,233
TX SD,Brazoria,Texas,48039,-95.46842957,29.20414925,191707,136.25,64019,99590,92117,154875,15981,812,1961,18078,33797,15565,40680,120514,14948,74504,10485,44317,19702,61800,313
TX SD,Brazos,Texas,48041,-96.33547592,30.65890217,121862,206.9,43725,62685,59177,94866,13672,274,4313,8737,16713,8253,17920,87575,8114,48799,5074,18308,25417,66600,336
TX SD,Brooks,Texas,48047,-98.26388931,27.02974606,8204,8.71,2673,3975,4229,6748,3,13,10,1430,7338,750,1964,4414,1076,3104,431,1917,756,26700,99
TX SD,Calhoun,Texas,48057,-96.62590027,28.39452267,19053,35.28,6777,9439,9614,14819,556,35,556,3087,6893,1432,4186,11330,2105,9559,2782,4813,1964,45000,249
TX SD,Cameron,Texas,48061,-97.52037811,26.13225079,260120,287.11,73278,124681,135439,214424,825,413,750,43708,212995,23151,68689,140765,27515,88759,15481,47172,26106,38400,235
TX SD,Chambers,Texas,48071,-94.66987991,29.71804905,20088,32.61,6930,10101,9987,16725,2550,53,116,644,1195,1387,4588,12210,1903,8061,1131,5605,1325,57000,266
TX SD,Colorado,Texas,48089,-96.53044891,29.59964657,18383,19.05,7024,8807,9576,13352,3118,30,16,1867,2833,1291,3602,9825,3665,8537,1513,5327,1697,45300,185
TX SD,De Witt,Texas,48123,-97.36983871,29.1017065,18840,20.7,7195,8916,9924,14356,2114,22,17,2331,4567,1299,3758,9808,3975,8568,1373,5320,1875,35500,165
TX SD,Duval,Texas,48131,-98.52322388,27.66398811,12918,7.2,4159,6306,6612,10183,12,12,17,2694,11267,1123,3105,6998,1692,5127,968,3322,837,23400,172
TX SD,Fayette,Texas,48149,-96.95051956,29.9015274,20095,21.15,8101,9772,10323,17323,1686,29,15,1042,1702,1213,3611,10588,4683,10756,2655,6086,2015,53100,208
TX SD,Fort Bend,Texas,48157,-95.7522049,29.53388119,225421,257.33,70424,113246,112175,141125,46593,525,14328,22850,43892,21297,53525,139474,11125,77075,6651,53115,17309,71600,401
TX SD,Galveston,Texas,48167,-95.02557755,29.38228512,217399,544.86,81451,106950,110449,164210,38154,752,3569,10714,30962,16605,43296,134727,22771,99451,18000,50463,30988,59700,322
TX SD,Goliad,Texas,48175,-97.46982574,28.6534996,5980,6.96,2208,2881,3099,4953,407,19,5,596,2145,425,1212,3329,1014,2835,627,1722,486,39900,201
TX SD,Grimes,Texas,48185,-95.98887253,30.54632568,18828,23.56,6040,10277,8551,12879,4614,52,30,1253,2657,1289,3650,11307,2582,7744,1704,4472,1568,39300,199
TX SD,Harris,Texas,48201,-95.43951416,29.83701706,2818199,1625.26,1026448,1400246,1417953,1824137,541180,8044,110848,333990,644935,242870,562139,1814968,198222,1173808,147360,533815,492633,63500,339
TX SD,Hidalgo,Texas,48215,-98.2336998,26.4108572,383545,244.45,103479,185199,198346,286858,806,668,1088,94125,326972,35765,104656,204686,38438,128241,24762,72715,30764,35900,221
TX SD,Jackson,Texas,48239,-96.6194458,28.96232891,13039,15.45,4833,6279,6760,10857,1218,41,12,911,2772,914,2762,7126,2237,5841,1008,3636,1197,42000,197
TX SD,Jim Hogg,Texas,48247,-98.69753647,27.07661247,5109,4.5,1675,2496,2613,4375,4,12,4,714,4659,475,1193,2749,692,2103,428,1308,367,28300,173
TX SD,Jim Wells,Texas,48249,-98.02043533,27.66208744,37679,43.46,11979,18539,19140,28504,218,82,103,8772,27201,3260,8994,21030,4395,13948,1969,8898,3081,33700,201
TX SD,Kenedy,Texas,48261,-97.64367294,26.94256401,460,0.33,145,225,235,378,0,0,0,82,362,36,102,281,41,213,68,29,116,22500,135
TX SD,Kleberg,Texas,48273,-97.64303589,27.42761707,30274,35.49,10058,15070,15204,20650,998,81,414,8131,18529,2554,6291,18456,2973,12008,1950,6000,4058,40800,273
TX SD,La Salle,Texas,48283,-99.10004807,28.33736992,5254,3.46,1701,2606,2648,3567,53,9,10,1615,4068,450,1295,2803,706,2244,543,1152,549,18300,149
TX SD,Lavaca,Texas,48285,-96.90596008,29.34928513,18690,19.25,7349,8935,9755,16541,1342,20,14,773,1596,1178,3425,9668,4419,9549,2200,5787,1562,40700,166
TX SD,Live Oak,Texas,48297,-98.07738495,28.42200565,9556,9.04,3550,4696,4860,8316,10,36,31,1163,3324,651,1964,5377,1564,5519,1969,2838,712,42000,202
TX SD,Madison,Texas,48313,-95.93115234,30.96837234,10931,23.16,3349,6367,4564,7984,2575,67,13,292,1178,624,1728,6834,1745,4326,977,2528,821,41900,225
TX SD,Matagorda,Texas,48321,-95.92636871,28.86019516,36928,32.77,13164,18274,18654,26622,5106,88,842,4270,9088,3187,8416,21053,4272,18540,5376,8559,4605,53000,269
TX SD,McMullen,Texas,48311,-98.57348633,28.34984875,817,0.7,319,410,407,713,0,3,0,101,320,65,137,493,122,565,246,242,77,40000,150
TX SD,Montgomery,Texas,48339,-95.46112442,30.33179855,182201,174.02,63563,90544,91657,166107,7763,687,1232,6412,13237,14378,39714,112416,15693,73871,10308,45730,17833,69400,325
TX SD,Nueces,Texas,48355,-97.5007782,27.77875042,291145,343.74,99740,142414,148731,220168,12691,1175,2483,54628,152051,24043,64781,172899,29422,114326,14586,58066,41674,54700,300
TX SD,Refugio,Texas,48391,-97.14515305,28.30587292,7976,10.35,2937,3821,4155,6201,645,25,5,1100,3164,520,1674,4486,1296,3739,802,2097,840,39300,193
TX SD,San Jacinto,Texas,48407,-95.09981918,30.61441803,16372,28.62,6247,8208,8164,13525,2544,74,14,215,431,1029,3269,9513,2561,9823,3576,5286,961,40300,217
TX SD,San Patricio,Texas,48409,-97.50616837,27.99123669,58749,84.77,18776,29076,29673,44834,968,219,163,12565,29809,4827,14165,33660,6097,22126,3350,12824,5952,47000,254
TX SD,Starr,Texas,48427,-98.75497818,26.51533699,40518,33.05,10331,19927,20591,25067,25,31,25,15370,39390,4019,11946,21695,2858,12209,1878,8137,2194,21900,163
TX SD,Victoria,Texas,48469,-96.98288727,28.79557419,74361,83.83,26228,36182,38179,59251,4906,208,257,9739,25372,6141,16396,43706,8118,29162,2934,16943,9285,54700,276
TX SD,Walker,Texas,48471,-95.5950737,30.78937149,50917,64.78,14918,30368,20549,34946,12334,187,323,3127,5493,2714,6972,36736,4495,18349,3431,8561,6357,60300,323
TX SD,Waller,Texas,48473,-96.00307083,29.99047565,23390,45.51,7402,11490,11900,12987,8796,28,69,1510,2592,1572,4358,14898,2562,8824,1422,5084,2318,54300,237
TX SD,Webb,Texas,48479,-99.51041031,27.73676014,133239,39.63,34438,63927,69312,93657,156,201,484,38741,125069,13521,35356,73869,10493,37197,2759,20884,13554,49800,243
TX SD,Wharton,Texas,48481,-96.24848557,29.29963303,39955,36.79,14210,19498,20457,29127,6308,38,131,4351,10103,3140,8802,22258,5755,16277,2067,9429,4781,49300,227
TX SD,Willacy,Texas,48489,-97.61838531,26.45727634,17705,30.06,5049,8560,9145,13820,79,29,13,3764,14937,1571,4903,9255,1976,6072,1023,3813,1236,25800,155
TX SD,Zapata,Texas,48505,-99.21166992,26.94398689,9279,9.29,2862,4560,4719,6680,1,9,8,2581,7519,879,2349,4665,1386,4225,1363,2346,516,35500,163
TX WD,Andrews,Texas,48003,-102.6325226,32.30362511,14338,9.55,4758,7088,7250,10834,274,82,154,2994,4552,1322,3641,8014,1361,5462,704,3626,1132,39200,243
TX WD,Atascosa,Texas,48013,-98.45479965,28.92869759,30533,25.07,9940,15112,15421,25019,143,109,65,5197,16064,2598,7494,16860,3581,11614,1674,7513,2427,37800,199
TX WD,Bandera,Texas,48019,-99.20532227,29.74191475,10562,13.32,4180,5246,5316,10027,23,66,26,420,1172,637,1871,6188,1866,6485,2305,3327,853,61900,256
TX WD,Bastrop,Texas,48021,-97.34804153,30.10430622,38263,42.75,13379,19416,18847,29607,4512,181,129,3834,6933,3063,7958,22510,4732,16301,2922,10376,3003,53900,253
TX WD,Bell,Texas,48027,-97.49560547,31.04542923,191088,181.13,67240,97344,93744,136066,36095,944,5531,12452,24995,18264,36769,119309,16746,75957,8717,35059,32181,59000,301
TX WD,Bexar,Texas,48029,-98.46968079,29.43903732,1185394,949.83,409043,575060,610334,878736,84670,4265,15429,202294,589180,99881,246060,722083,117370,455832,46789,236411,172632,56300,317
TX WD,Blanco,Texas,48031,-98.3598671,30.22703934,5972,8.36,2338,2849,3123,5598,56,17,22,279,840,404,1086,3272,1210,3135,797,1702,636,56400,210
TX WD,Bosque,Texas,48035,-97.64066696,31.9038105,15125,15.29,5990,7302,7823,14173,319,26,41,566,1430,921,2641,7847,3716,8074,2084,4543,1447,42000,211
TX WD,Brewster,Texas,48043,-103.0583115,29.82324123,8681,1.41,3350,4381,4300,8300,85,20,52,224,3702,562,1490,5412,1217,4486,1136,1995,1355,45500,227
TX WD,Burleson,Texas,48051,-96.62104797,30.51904106,13625,20.37,5176,6644,6981,10173,2430,53,18,951,1624,985,2728,7532,2380,7044,1868,4079,1097,41600,215
TX WD,Burnet,Texas,48053,-98.14598846,30.74082184,22677,22.81,9055,10941,11736,20793,269,109,59,1447,2440,1452,4124,12003,5098,12801,3746,6853,2202,58400,246
TX WD,Caldwell,Texas,48055,-97.62432098,29.85737514,26392,48.34,8745,13254,13138,18919,2825,65,86,4497,9988,2047,5783,14972,3590,10123,1378,5980,2765,44200,223
TX WD,Comal,Texas,48091,-98.32934952,29.81690788,51832,93.39,19315,25258,26574,46821,443,148,164,4256,11864,3633,9623,30194,8382,22987,3672,14291,5024,76500,338
TX WD,Coryell,Texas,48099,-97.80003357,31.3918438,64213,60.75,16687,36229,27984,45078,13592,461,1670,3412,6243,5413,11527,43687,3586,18970,2283,8630,8057,51200,330
TX WD,Crane,Texas,48103,-102.5357819,31.37089634,4652,5.95,1537,2321,2331,3097,130,11,10,1404,1577,390,1224,2579,459,1795,258,1233,304,37500,217
TX WD,Culberson,Texas,48109,-104.4703064,31.34445763,3407,0.89,1076,1729,1678,2400,2,16,27,962,2419,328,860,1922,297,1286,210,699,377,27500,191
TX WD,Dimmit,Texas,48127,-99.75241852,28.42060661,10433,7.98,3072,5096,5337,7599,60,16,12,2746,8688,920,2871,5433,1209,3991,919,2281,791,21600,167
TX WD,Ector,Texas,48135,-102.5448685,31.86922836,118934,131.71,42322,58211,60723,91309,5557,647,662,20759,37315,10796,26915,70175,11048,48789,6467,27858,14464,43400,239
TX WD,Edwards,Texas,48137,-100.2248993,29.9553299,2266,1.07,795,1138,1128,2114,0,4,4,144,1182,183,563,1237,283,1550,755,574,221,30900,169
TX WD,El Paso,Texas,48141,-106.3057251,31.69768524,591610,583.44,178366,287602,304008,452512,22110,2590,6485,107913,411619,53041,139771,350531,48267,187473,9107,104624,73742,57300,301
TX WD,Falls,Texas,48145,-96.93545151,31.26241112,17712,23,6492,8862,8850,11390,4810,41,21,1450,2072,1267,3257,9690,3498,7733,1241,4559,1933,31400,150
TX WD,Freestone,Texas,48161,-96.14199066,31.71793175,15818,17.81,6063,7623,8195,12382,3013,53,37,333,619,1038,3249,8476,3055,7812,1749,4819,1244,44700,197
TX WD,Frio,Texas,48163,-99.11043549,28.86451149,13472,11.89,4129,6672,6800,9119,183,23,38,4109,9749,1225,3460,7299,1488,4879,750,2791,1338,26800,167
TX WD,Gillespie,Texas,48171,-98.94797516,30.32351589,17204,16.21,6711,8245,8959,16325,34,60,27,758,2426,1040,2968,9003,4193,8265,1554,5321,1390,63900,292
TX WD,Gonzales,Texas,48177,-97.50009918,29.45051861,17205,16.11,6231,8424,8781,13025,1716,46,23,2395,6142,1363,3592,9201,3049,7810,1579,4247,1984,36800,160
TX WD,Guadalupe,Texas,48187,-97.98451233,29.61736298,64873,90.99,22663,32016,32857,52948,3665,235,465,7560,19246,5125,13366,38596,7786,25592,2929,16410,6253,60100,279
TX WD,Hamilton,Texas,48193,-98.11022568,31.72285843,7733,9.25,3250,3679,4054,7389,2,21,24,297,403,457,1269,3902,2105,4266,1016,2509,741,33300,182
TX WD,Hays,Texas,48209,-98.01503754,30.05330181,65614,96.78,22218,32911,32703,55360,2220,230,427,7377,18249,4373,11617,44414,5210,25247,3029,12940,9278,81300,337
TX WD,Hill,Texas,48217,-97.10804749,31.99813747,27146,28.04,10268,12998,14148,23669,2520,80,38,839,2230,1794,5060,14608,5684,12899,2631,7624,2644,37200,205
TX WD,Hudspeth,Texas,48229,-105.4520874,31.32279682,2915,0.64,946,1505,1410,2345,15,9,2,544,1935,216,712,1695,292,1288,342,651,295,23100,179
TX WD,Jeff Davis,Texas,48243,-104.2149086,30.75728321,1946,0.86,779,1001,945,1671,7,12,4,252,770,110,403,1064,369,1348,569,523,256,43800,213
TX WD,Karnes,Texas,48255,-97.88115692,28.94884872,12455,16.54,4337,5947,6508,9548,362,35,14,2496,5916,1021,2777,6430,2227,5117,780,3229,1108,29600,154
TX WD,Kendall,Texas,48259,-98.67415237,29.92920017,14589,22,5342,7098,7491,13682,58,71,38,740,2392,1025,2805,8410,2349,6137,795,3979,1363,79000,340
TX WD,Kerr,Texas,48265,-99.34173584,30.03867912,36304,32.79,14384,17174,19130,32842,805,128,141,2388,5994,2273,6158,18908,8965,17161,2777,9991,4393,67300,294
TX WD,Kimble,Texas,48267,-99.71373367,30.500947,4122,3.3,1624,2018,2104,3654,2,5,10,451,772,266,786,2195,875,2593,969,1198,426,38900,191
TX WD,Kinney,Texas,48271,-100.4558373,29.35318565,3119,2.3,1187,1580,1539,2746,57,26,9,281,1570,197,588,1645,689,1821,634,814,373,32400,173
TX WD,Lampasas,Texas,48281,-98.23815536,31.24822235,13521,18.94,5058,6559,6962,12164,268,79,136,874,1753,1052,2695,7649,2125,6193,1135,3676,1382,49600,227
TX WD,Lee,Texas,48287,-96.99121857,30.30227375,12854,20.37,4706,6488,6366,10057,1780,14,15,988,1410,931,2883,6996,2044,5773,1067,3648,1058,47800,241
TX WD,Leon,Texas,48289,-95.99029541,31.31686497,12665,11.74,5006,6143,6522,10730,1615,39,8,273,509,871,2404,6882,2508,7019,2013,4062,944,43500,223
TX WD,Limestone,Texas,48293,-96.58403778,31.52727222,20946,22.52,7722,9886,11060,15695,4156,41,50,1004,1459,1498,4010,11460,3978,9922,2200,5647,2075,36900,209
TX WD,Llano,Texas,48299,-98.6543541,30.71070766,11631,12.39,5278,5496,6135,11386,22,39,20,164,453,520,1382,5764,3965,9773,4495,4188,1090,66700,237
TX WD,Loving,Texas,48301,-103.6564941,31.83140182,107,0.16,42,59,48,93,0,0,0,14,14,6,22,65,14,59,17,31,11,14999,175
TX WD,Martin,Texas,48317,-101.9506569,32.30474472,4956,5.42,1632,2460,2496,3159,89,11,8,1689,1960,441,1253,2682,580,2039,407,1182,450,40500,183
TX WD,Mason,Texas,48319,-99.22175217,30.7242651,3423,3.66,1435,1631,1792,3084,6,13,4,316,671,203,602,1779,839,2356,921,1110,325,35200,134
TX WD,Maverick,Texas,48323,-100.3895798,28.64545059,36378,28.27,9756,17292,19086,23748,32,714,71,11813,34024,3476,10358,19462,3082,11143,1387,6533,3223,36200,176
TX WD,McCulloch,Texas,48307,-99.34503174,31.21614647,8778,8.2,3409,4190,4588,7855,166,14,8,735,2317,622,1746,4455,1955,4424,1015,2446,963,33900,186
TX WD,McLennan,Texas,48309,-97.20213699,31.55890369,189123,183.44,70208,91808,97315,146100,29520,563,1384,11556,23643,14205,35033,114265,25620,78857,8649,41352,28856,50300,282
TX WD,Medina,Texas,48325,-99.11228561,29.39399529,27312,20.52,9109,13549,13763,23608,92,119,68,3425,12134,2126,5977,15377,3832,10860,1751,7130,1979,45300,221
TX WD,Midland,Texas,48329,-102.0312729,31.87002563,106611,118.19,38920,51758,54853,86977,8281,414,888,10051,22780,10002,23441,63639,9529,45181,6261,25645,13275,62300,283
TX WD,Milam,Texas,48331,-96.96530151,30.79587173,22946,22.52,8686,11125,11821,18603,2940,69,37,1297,3456,1632,4843,12175,4296,10511,1825,6268,2418,40000,190
TX WD,Pecos,Texas,48371,-102.6719742,30.71903324,14675,3.07,4712,7265,7410,9449,62,45,31,5088,8331,1270,3796,8163,1446,5841,1129,3288,1424,38100,206
TX WD,Presidio,Texas,48377,-104.3869629,29.9542923,6637,1.72,2255,3215,3422,5624,6,16,16,975,5417,528,1615,3574,920,2890,635,1559,696,28200,147
TX WD,Real,Texas,48385,-99.83080673,29.8560133,2412,3.46,924,1160,1252,2064,0,23,0,325,574,148,417,1352,495,2049,1125,718,206,38300,172
TX WD,Reeves,Texas,48389,-103.560215,31.38901329,15852,6.04,4838,8170,7682,15293,347,36,36,140,11545,1400,3915,8899,1638,6044,1206,3605,1233,25800,191
TX WD,Robertson,Texas,48395,-96.53559875,31.03586388,15511,17.95,5793,7418,8093,10047,4259,36,15,1154,1904,1259,3177,8224,2851,7338,1545,4118,1675,37400,156
TX WD,San Saba,Texas,48411,-98.7538414,31.20544624,5401,4.75,2122,2638,2763,4944,14,8,1,434,998,358,1042,2751,1250,3078,956,1548,574,33100,169
TX WD,Somervell,Texas,48425,-97.77873993,32.20933723,5360,28.51,1902,2712,2648,4849,10,34,22,445,749,448,1269,3002,641,2429,527,1349,553,55300,246
TX WD,Terrell,Texas,48443,-102.1094322,30.2222414,1410,0.6,524,737,673,1189,1,5,2,213,751,90,327,793,200,810,286,343,181,27200,150
TX WD,Terry,Texas,48445,-102.3315048,33.17067719,13218,14.9,4478,6408,6810,10202,449,38,28,2501,5194,1136,3238,7045,1799,5296,818,3249,1229,38600,223
TX WD,Travis,Texas,48453,-97.7726059,30.32892418,576407,582.82,232861,288256,288151,422749,63173,2089,16497,71899,121689,44113,94098,396335,41861,264173,31312,106488,126373,78300,349
TX WD,Upton,Texas,48461,-102.0375481,31.37133503,4447,3.58,1472,2201,2246,3487,94,20,2,844,1666,388,1200,2440,419,1868,396,1107,365,27600,174
TX WD,Uvalde,Texas,48463,-99.76420593,29.35962105,23340,14.92,7553,11257,12083,15078,47,49,70,8096,14104,2005,5487,12932,2916,9692,2139,5217,2336,38600,204
TX WD,Val Verde,Texas,48465,-101.2249222,29.76504803,38721,12.29,11840,19191,19530,26694,757,126,244,10900,27299,3565,9191,22222,3743,13905,2065,7234,4606,43400,267
TX WD,Ward,Texas,48475,-103.1844711,31.46225929,13115,15.69,4444,6534,6581,9905,457,75,25,2653,4830,1048,3298,7309,1460,5365,921,3416,1028,33300,223
TX WD,Washington,Texas,48477,-96.44192886,30.22806644,26154,42.88,9619,12674,13480,19782,5463,46,186,677,1158,1811,4842,14975,4526,11717,2098,6964,2655,58600,262
TX WD,Williamson,Texas,48491,-97.6003685,30.66310406,139551,122.74,48792,68682,70869,121914,6861,508,1846,8422,20004,12247,30942,85731,10631,54466,5674,31211,17581,72300,350
TX WD,Wilson,Texas,48493,-98.07615662,29.1628027,22650,28.07,7481,11275,11375,19652,242,45,22,2689,8054,1814,5199,12769,2868,8516,1035,6031,1450,49900,196
TX WD,Winkler,Texas,48495,-103.069294,31.86972618,8626,10.27,2941,4261,4365,6184,167,48,9,2218,3172,711,2158,4656,1101,3708,767,2362,579,29200,215
TX WD,Zavala,Texas,48507,-99.76204681,28.86524487,12162,9.37,3356,6141,6021,6443,296,16,3,5404,10875,1169,3178,6515,1300,4180,824,2330,1026,20300,104
UT D,Beaver,Utah,49001,-113.1924095,38.35838127,4765,1.84,1594,2333,2432,4647,5,39,19,55,120,382,1348,2260,775,2200,606,1356,238,51200,190
UT D,Box Elder,Utah,49003,-112.9498749,41.49949455,36485,6.5,10954,18203,18282,34733,19,391,409,933,1610,3791,11016,18105,3573,11890,936,8653,2301,65000,258
UT D,Cache,Utah,49005,-111.7678146,41.68606758,70183,59.93,21021,35256,34927,66551,217,547,1910,958,1780,7508,18115,38862,5698,22053,1032,13161,7860,67100,268
UT D,Carbon,Utah,49007,-110.5534477,39.63426208,20228,13.68,6907,9834,10394,19060,62,150,116,840,2247,1603,5379,10546,2700,8713,1806,5230,1677,51500,223
UT D,Daggett,Utah,49009,-109.523468,40.82990646,690,0.99,253,352,338,674,0,9,5,2,15,63,176,383,68,825,572,152,101,50400,187
UT D,Davis,Utah,49011,-112.1171112,40.96368027,187941,628.57,53598,94506,93435,178391,2355,1114,3263,2818,7275,20000,55426,100948,11567,55777,2179,39711,13887,75700,329
UT D,Duchesne,Utah,49013,-110.4345207,40.3170948,12645,3.91,3707,6385,6260,11807,10,664,39,125,350,1356,4082,6137,1070,5860,2153,3020,687,43400,224
UT D,Emery,Utah,49015,-110.6450119,39.09813118,10332,2.32,2998,5268,5064,10127,4,44,36,121,219,985,3462,5077,808,3928,930,2467,531,48500,209
UT D,Garfield,Utah,49017,-111.3085136,37.83831215,3980,0.77,1321,2031,1949,3890,1,73,8,8,35,367,1060,1997,556,2488,1167,1082,239,49800,202
UT D,Grand,Utah,49019,-109.6115036,39.00642967,6620,1.79,2489,3214,3406,6341,7,203,24,45,291,521,1590,3683,826,2992,503,1831,658,49700,226
UT D,Iron,Utah,49021,-113.2571983,37.80249405,20789,6.3,6269,10342,10447,19922,43,635,98,91,382,1874,5501,11434,1980,8499,2230,4378,1891,63400,267
UT D,Juab,Utah,49023,-112.811039,39.65496635,5817,1.71,1801,2887,2930,5680,2,85,10,40,73,505,1758,2736,818,2311,510,1442,359,43300,194
UT D,Kane,Utah,49025,-111.7707825,37.26696014,5169,1.33,1724,2605,2564,5032,5,77,25,30,101,455,1440,2559,715,3237,1513,1335,389,63100,217
UT D,Millard,Utah,49027,-113.0251923,39.0610714,11333,1.66,3349,5705,5628,10798,2,184,105,244,402,1199,3668,5104,1362,4125,776,2655,694,50400,199
UT D,Morgan,Utah,49029,-111.5341492,41.08099556,5528,9.17,1555,2780,2748,5462,7,8,15,36,78,512,1761,2797,458,1681,126,1286,269,78000,286
UT D,Piute,Utah,49031,-112.1410523,38.32309341,1277,1.68,449,652,625,1267,0,9,1,0,15,81,334,614,248,704,255,385,64,45500,150
UT D,Rich,Utah,49033,-111.2749863,41.57217216,1725,1.67,521,879,846,1704,1,1,6,13,21,186,558,787,194,1859,1338,410,111,45900,192
UT D,Salt Lake,Utah,49035,-111.9009247,40.66709328,725956,960.26,240680,360061,365895,675141,5663,6111,20035,19006,43647,69698,182719,412211,61328,257339,16659,156753,83927,71000,316
UT D,San Juan,Utah,49037,-110.1989975,37.74489403,12621,1.63,3375,6245,6376,5501,11,6859,40,210,440,1523,3948,6260,890,4650,1275,2609,766,37800,184
UT D,Sanpete,Utah,49039,-111.6251907,39.42132187,16259,10.25,4859,7980,8279,15539,11,131,246,332,560,1352,4832,7925,2150,6570,1711,3875,984,49000,221
UT D,Sevier,Utah,49041,-111.9055862,38.7696228,15431,8.08,4877,7640,7791,14982,6,318,27,98,289,1394,4678,7259,2100,6059,1182,4019,858,51600,224
UT D,Summit,Utah,49043,-110.8196793,40.90681648,15518,8.32,5271,7931,7587,15304,18,66,78,52,326,1385,3798,9443,892,11256,5985,3753,1518,107800,451
UT D,Tooele,Utah,49045,-113.0930367,40.48888206,26601,3.84,8581,13446,13155,24347,228,391,205,1430,2960,2311,7310,14688,2292,9510,929,6027,2554,60400,292
UT D,Uintah,Utah,49047,-109.5427284,40.15336609,22211,4.96,6670,10991,11220,19537,9,2335,82,248,691,2282,6914,11274,1741,8142,1472,5052,1618,44400,183
UT D,Utah,Utah,49049,-111.5302239,40.18083191,263590,130.62,70168,130281,133309,253596,374,1913,3958,3749,8488,28275,71229,145669,18417,72820,2652,43990,26178,70000,288
UT D,Wasatch,Utah,49051,-111.2461662,40.28806686,10089,8.47,3074,5058,5031,9937,3,68,19,62,253,975,3011,5167,936,4465,1391,2337,737,69900,296
UT D,Washington,Utah,49053,-113.4719162,37.30471802,48560,20.05,15256,23825,24735,47202,66,706,290,296,862,4554,13040,23068,7898,19523,4267,10805,4451,78400,346
UT D,Wayne,Utah,49055,-110.8691368,38.32556343,2177,0.88,699,1123,1054,2123,1,40,2,11,25,181,640,1020,336,1061,362,571,128,54000,174
UT D,Weber,Utah,49057,-111.9528656,41.25244141,158330,279.73,53253,77946,80384,146550,2446,1112,2300,5922,11042,14315,39018,87435,17562,57851,4598,37634,15619,66000,286
VA ED,Accomack,Virginia,51001,-75.59184265,37.74878502,31703,66.6,12653,14971,16732,20499,10938,40,71,155,452,2042,5479,18331,5851,15840,3187,9470,3183,52700,219
VA ED,Alexandria,Virginia,51510,-77.09044266,38.81946564,111183,7412.2,53280,52741,58442,76789,24339,333,4632,5090,10778,6207,10925,82645,11406,58252,4972,21566,31714,228600,667
VA ED,Amelia,Virginia,51007,-77.94605255,37.34006882,8787,24.61,3131,4341,4446,5933,2822,14,13,5,45,617,1679,5335,1156,3439,308,2520,611,54900,219
VA ED,Arlington,Virginia,51013,-77.10844421,38.88523674,170936,6574.46,78520,83995,86941,130873,17940,537,11560,10026,23089,9426,16452,125649,19409,84847,6327,35009,43511,231000,678
VA ED,Bristol,Virginia,51520,-82.1869545,36.60780525,18426,1535.5,7591,8224,10202,17240,1063,13,91,19,64,1106,2867,10998,3455,8174,583,4789,2802,48400,232
VA ED,Brunswick,Virginia,51025,-77.85503769,36.79107475,15987,28.4,5499,7922,8065,6605,9349,9,12,12,47,983,2852,9861,2291,6456,957,4111,1388,42900,150
VA ED,Buena Vista,Virginia,51530,-79.36204147,37.72380638,6406,2135.33,2404,2907,3499,6093,282,5,21,5,12,323,1065,3983,1035,2494,90,1736,668,43300,194
VA ED,Caroline,Virginia,51033,-77.36079025,38.01384926,19217,35.92,6631,9530,9687,11686,7244,203,49,35,100,1431,3584,11930,2272,7292,661,5303,1328,64700,288
VA ED,Charles City,Virginia,51036,-77.07736206,37.36329269,6282,34.71,2161,3071,3211,1800,3969,489,11,13,24,392,1115,4065,710,2314,153,1863,298,52100,229
VA ED,Chesapeake,Virginia,51550,-76.28458023,36.71173477,151976,446.99,51965,74467,77509,107399,41662,444,1899,572,1913,12585,31044,95503,12844,55742,3777,37916,14049,88200,399
VA ED,Chesterfield,Virginia,51041,-77.56281662,37.38901901,209274,482.2,73441,102361,106913,177067,27196,487,3738,786,2511,16834,44101,135524,12815,77329,3888,58385,15056,87200,447
VA ED,Dinwiddie,Virginia,51053,-77.65250778,37.0748291,20960,41.34,7492,10321,10639,13348,7471,33,60,48,122,1402,3691,13276,2591,8023,531,6002,1490,56900,239
VA ED,Essex,Virginia,51057,-76.92542648,37.94991493,8689,33.04,3258,4086,4603,5329,3270,46,40,4,30,514,1526,5098,1551,4073,815,2571,687,68200,277
VA ED,Fairfax,Virginia,51059,-77.44285632,38.84264374,818584,2077.62,292345,407017,411567,665399,63325,2038,69338,18484,51874,57892,142176,564972,53544,307966,15621,206793,85552,213800,748
VA ED,Fairfax City,Virginia,51600,-77.30796051,38.84566307,19622,3270.33,7362,9568,10054,16830,966,43,1409,374,1159,1106,2653,13728,2135,7677,315,4855,2507,184300,729
VA ED,Falls Chruch,Virginia,51610,-77.17255402,38.87915421,9578,4789,4195,4573,5005,8533,298,42,456,249,604,551,1312,6276,1439,4668,473,2467,1728,226000,769
VA ED,Fauquier,Virginia,51061,-77.83676529,38.71204567,48741,74.87,16509,24556,24185,42657,5462,113,291,218,602,3883,9183,31171,4504,17716,1207,12106,4403,146500,498
VA ED,Fredericksburg,Virginia,51630,-77.46776199,38.28563499,19027,3171.17,7450,8695,10332,14468,4115,27,205,212,463,1264,2278,12891,2594,8063,613,2779,4671,104900,461
VA ED,Gloucester,Virginia,51073,-76.55489349,37.42787361,30131,133.92,10966,14874,15257,26448,3354,70,195,64,287,2274,5950,18552,3355,12451,1485,8826,2140,84000,356
VA ED,Goochland,Virginia,51075,-77.89561844,37.73400688,14163,50.4,4880,6932,7231,9895,4210,16,33,9,33,914,2092,9590,1567,5203,323,4108,772,90100,282
VA ED,Greensville,Virginia,51081,-77.54199219,36.72424889,8853,29.51,3150,4223,4630,3900,4916,13,23,1,64,619,1792,5222,1220,3393,243,2475,675,45200,160
VA ED,Hampton,Virginia,51650,-76.36423492,37.04906082,133793,2623.39,49673,65226,68567,78149,51981,392,2339,932,2636,10499,22919,87574,12801,53623,3950,29429,20244,78200,385
VA ED,Hanover,Virginia,51085,-77.46323395,37.77551651,63306,135.56,22628,30963,32343,56440,6405,143,269,49,321,4371,11436,40790,6709,23727,1099,18892,3736,91300,423
VA ED,Henrico,Virginia,51087,-77.3027687,37.53061485,217881,915.47,89138,101211,116670,168453,43827,626,4364,611,2171,15001,35037,140859,26984,94539,5401,56848,32290,83900,436
VA ED,Hopewell,Virginia,51670,-77.29086304,37.29414749,23101,2310.1,9014,10961,12140,16687,5910,64,307,133,417,1884,4161,14049,3007,9625,611,5132,3882,54300,288
VA ED,Isle of Wight,Virginia,51093,-76.70949554,36.89507484,25053,78.54,9032,12300,12753,16975,7925,51,69,33,172,1906,4609,15730,2808,9753,721,7181,1851,83200,264
VA ED,James City,Virginia,51095,-76.75531006,37.32082367,34859,227.84,12968,17039,17820,27804,6460,69,452,74,382,2466,6027,22351,4015,14330,1362,9507,3461,119500,455
VA ED,King George,Virginia,51099,-77.17667389,38.26006508,13527,75.15,4736,6761,6766,10597,2734,37,119,40,156,1143,2657,8465,1262,5280,544,3298,1438,90000,386
VA ED,King William,Virginia,51101,-77.0640564,37.7136116,10913,39.26,3834,5268,5645,7351,3310,217,25,10,66,811,2105,6617,1380,4193,359,3114,720,70200,247
VA ED,King and Queen,Virginia,51097,-76.91916656,37.70027161,6289,19.84,2339,3078,3211,3573,2633,65,10,8,28,459,1127,3753,950,2698,359,1915,424,55600,228
VA ED,Lancaster,Virginia,51103,-76.47741699,37.73075485,10896,81.92,4564,5096,5800,7567,3289,6,12,22,75,548,1681,5849,2818,5918,1354,3727,837,90000,309
VA ED,Loudoun,Virginia,51107,-77.64323807,39.08463478,86129,165.31,30490,42814,43315,77095,6168,177,2101,588,2156,7613,15665,57628,5223,32932,2442,22341,8149,170200,682
VA ED,Lunenburg,Virginia,51111,-78.25507355,36.95093536,11419,26.43,4423,5534,5885,7081,4292,11,24,11,83,753,2206,6502,1958,5065,642,3434,989,37600,154
VA ED,Manassas City,Virginia,51683,-77.48745346,38.7444706,27957,3494.63,9481,14256,13701,23332,2889,90,867,779,1601,2732,5244,18597,1384,10232,751,6268,3213,150700,603
VA ED,Manassas Park City,Virginia,51685,-77.45405579,38.77311707,6734,3367,2182,3346,3388,5941,490,7,169,127,314,652,1440,4393,249,2252,70,1566,616,101800,602
VA ED,Martinsville,Virginia,51690,-79.86875916,36.68220901,16162,1469.27,6839,7276,8886,10134,5954,21,32,21,59,1032,2590,9410,3130,7310,471,4149,2690,52700,255
VA ED,Mathews,Virginia,51115,-76.35328674,37.42303848,8348,95.95,3530,3989,4359,7140,1175,11,15,7,49,403,1286,4768,1891,4725,1195,2940,590,79900,280
VA ED,Mecklenburg,Virginia,51117,-78.38668823,36.71784401,29241,47.47,11244,14038,15203,17926,11226,20,49,20,108,1766,5073,17374,5028,14589,3345,8058,3186,50700,149
VA ED,Middlesex,Virginia,51119,-76.63957144,37.64995193,8653,64.57,3530,4166,4487,6503,2131,6,9,4,48,493,1276,4984,1900,5486,1956,2922,608,77500,263
VA ED,New Kent,Virginia,51127,-76.98731995,37.50479317,10445,49.04,3718,5240,5205,8078,2151,136,34,46,78,737,1890,6900,918,3968,250,3264,454,86500,304
VA ED,Newport News,Virginia,51700,-76.50473404,37.09837723,170045,2616.08,63952,83356,86689,106418,57077,579,3969,2002,4710,15887,30779,107575,15804,69728,5776,31993,31959,85200,368
VA ED,Norfolk,Virginia,51710,-76.24324799,36.8905983,261229,4928.85,89478,139310,121919,148228,102012,1165,6815,3009,7611,21575,38412,173784,27458,98762,9284,39387,50091,74500,361
VA ED,Northampton,Virginia,51131,-75.90462112,37.34156036,13061,57.79,5129,6056,7005,6882,6035,16,16,112,256,893,2422,7157,2589,6183,1054,3372,1757,47700,151
VA ED,Northumberland,Virginia,51133,-76.44571686,37.86273003,10524,56.89,4492,4960,5564,7388,3098,9,19,10,51,560,1546,5799,2619,6841,2349,3912,580,80300,224
VA ED,Nottoway,Virginia,51135,-78.0265007,37.14075089,14993,47.45,5244,7634,7359,8740,6155,35,45,18,83,870,2483,8925,2715,5732,488,3833,1411,43000,194
VA ED,Petersburg,Virginia,51730,-77.39801407,37.20498276,38386,1668.96,14730,17716,20670,10194,27688,83,289,132,472,2861,6133,23651,5741,16196,1466,7491,7239,52000,257
VA ED,Poquoson City,Virginia,51735,-76.34962082,37.14235878,11005,647.35,3769,5483,5522,10728,84,24,161,8,96,670,2358,7052,925,3890,121,3117,652,113700,475
VA ED,Portsmouth,Virginia,51740,-76.35145187,36.8125515,103907,3463.57,38741,49454,54453,53212,49180,303,827,385,1364,8710,19147,61651,14399,42283,3542,21644,17097,67400,327
VA ED,Powhatan,Virginia,51145,-77.90420151,37.55529022,15328,58.73,4672,8619,6709,11954,3290,32,26,26,59,949,2574,10455,1350,4910,238,3976,696,74700,331
VA ED,Prince Edward,Virginia,51147,-78.46305466,37.23879051,17320,48.93,5373,8299,9021,10923,6265,29,77,26,114,967,2629,11234,2490,6075,702,3808,1565,54200,221
VA ED,Prince George,Virginia,51149,-77.18843079,37.16065598,27394,102.98,8250,14555,12839,18268,7972,100,592,462,1060,2110,5187,18416,1681,8640,390,5679,2571,75800,388
VA ED,Prince William,Virginia,51153,-77.47426605,38.72130013,215686,636.24,69709,110359,105327,179709,25078,718,6569,3612,9662,20044,45819,143289,6534,74759,5050,49505,20204,138500,637
VA ED,Radford,Virginia,51750,-80.56489944,37.1275959,15940,2277.14,5207,7067,8873,14643,957,16,272,52,175,562,1460,12563,1355,5496,289,2491,2716,64500,339
VA ED,Richmond,Virginia,51159,-76.73027802,37.95261955,7273,37.68,2645,3557,3716,5027,2194,8,23,21,52,439,1248,4181,1405,3179,534,2155,490,63100,215
VA ED,Richmond City,Virginia,51760,-77.4942131,37.52279091,203056,3384.27,85337,92795,110261,88028,112122,463,1787,656,1898,13965,28037,129873,31181,94141,8804,39515,45822,66600,333
VA ED,Salem,Virginia,51775,-80.06999969,37.29131126,23756,1696.86,9161,11370,12386,22473,1065,27,165,26,111,1234,3433,15145,3944,9609,448,6177,2984,69100,345
VA ED,South Boston,Virginia,51780,-78.90444565,36.69589424,6997,1166.17,2795,3081,3916,4376,2569,11,34,7,45,448,1197,3942,1410,2997,202,1795,1000,44000,188
VA ED,Southampton,Virginia,51175,-77.16361618,36.77557564,17550,29.1,6009,9213,8337,9634,7868,15,17,16,67,1080,3023,10943,2504,6560,551,4298,1711,57000,140
VA ED,Spotsylvania,Virginia,51177,-77.66427231,38.18901253,57403,142.09,18945,28478,28925,50220,6178,197,607,201,843,5050,12378,35766,4209,20483,1538,15516,3429,104000,565
VA ED,Stafford,Virginia,51179,-77.46266937,38.41953468,61236,225.96,19415,31625,29611,55546,4304,233,746,407,1252,5154,12989,39466,3627,20529,1114,15901,3514,125400,538
VA ED,Suffolk,Virginia,51800,-76.67246628,36.73790169,52141,127.48,18516,24708,27433,28511,23245,112,200,73,319,3972,10171,31246,6752,20011,1495,12544,5972,70700,250
VA ED,Surry,Virginia,51181,-76.91467285,37.09957123,6145,21.87,2283,2956,3189,2722,3411,10,2,0,19,450,1171,3618,906,2982,699,1746,537,59400,220
VA ED,Sussex,Virginia,51183,-77.28546524,36.91033745,10248,20.87,3795,4878,5370,4253,5955,11,16,13,23,720,1816,6143,1569,4252,457,2630,1165,48200,185
VA ED,Virginia Beach,Virginia,51810,-76.05296707,36.7437458,393069,1535.43,135566,199571,193498,316408,54671,1384,17025,3581,12137,34801,75086,259968,23214,147037,11471,84719,50847,96500,484
VA ED,Waynesboro,Virginia,51820,-78.89030457,38.06862068,18549,2318.63,7568,8763,9786,16681,1749,34,44,41,150,1279,3008,11143,3119,7902,334,4712,2856,68100,297
VA ED,Westmoreland,Virginia,51193,-76.81089783,38.12450981,15480,68.19,6057,7445,8035,10257,5104,31,67,21,100,1055,2554,8933,2938,8378,2321,4801,1256,68800,309
VA ED,Williamsburg,Virginia,51830,-76.70016479,37.2741642,11530,2306,3468,5347,6183,9368,1754,25,335,48,151,306,752,9100,1372,3960,492,1262,2206,121000,428
VA ED,Winchester,Virginia,51840,-78.16913986,39.17058563,21947,2438.56,9084,10497,11450,19453,2199,26,209,60,219,1526,3216,13860,3345,9808,724,4122,4962,89100,349
VA ED,York,Virginia,51199,-76.57012939,37.23034286,42422,375.42,14474,21133,21289,34487,6613,112,988,222,723,2963,9419,26872,3168,15284,810,10359,4115,121600,442
VA WD,Albemarle,Virginia,51003,-78.52334976,38.00189018,68040,93.85,24433,33209,34831,59264,6824,75,1643,234,786,4655,10621,46166,6598,25958,1525,15661,8772,111200,454
VA WD,Alleghany,Virginia,51005,-79.9530983,37.7828331,13176,29.54,4942,6552,6624,12792,329,13,40,2,54,767,2420,8191,1798,5481,539,4055,887,50100,185
VA WD,Amherst,Virginia,51009,-79.15929031,37.59482956,28578,59.66,9827,13747,14831,22576,5758,128,74,42,231,1798,4909,18342,3529,10598,771,7725,2102,56900,250
VA WD,Appomattox,Virginia,51011,-78.8061409,37.37896729,12298,36.6,4531,5951,6347,9459,2816,14,6,3,30,790,2274,7423,1811,4913,382,3675,856,51000,209
VA WD,Augusta,Virginia,51015,-79.12672424,38.1836834,54677,55.29,19781,27612,27065,52434,2006,48,132,57,239,3519,9946,35030,6182,21202,1421,15931,3850,70500,265
VA WD,Bath,Virginia,51017,-79.74882126,38.05553055,4799,8.92,1895,2439,2360,4533,251,2,8,5,23,259,758,3036,746,2596,701,1451,444,46700,214
VA WD,Bedford,Virginia,51019,-79.69127596,37.3143692,45656,61.12,17292,22715,22941,41856,3612,60,114,14,177,3007,7892,29184,5573,19641,2349,14844,2448,75800,272
VA WD,Bedford City,Virginia,51515,-79.52315521,37.32886124,6073,867.57,2475,2853,3220,4691,1338,7,33,4,53,371,893,3301,1508,2625,150,1543,932,55700,191
VA WD,Bland,Virginia,51021,-81.15354156,37.13420677,6514,18.14,2244,3472,3042,6257,230,3,8,16,24,334,1110,4182,888,2706,462,1903,341,43800,171
VA WD,Botetourt,Virginia,51023,-79.79108429,37.55111694,24992,45.86,9148,12535,12457,23745,1121,15,75,36,143,1439,4367,16139,3047,9785,637,7842,1306,73400,249
VA WD,Buchanan,Virginia,51027,-82.01385498,37.28592491,31333,62.17,11061,15516,15817,31107,63,26,47,90,257,1727,6882,20002,2722,12222,1161,8942,2119,41700,188
VA WD,Buckingham,Virginia,51029,-78.54626083,37.56225586,12873,22.08,4341,6720,6153,7564,5259,17,27,6,38,885,2150,7960,1878,5013,672,3394,947,44900,175
VA WD,Campbell,Virginia,51031,-79.13256836,37.22750473,47572,94.2,17952,23458,24114,40418,6876,44,168,66,216,3173,8413,30511,5475,19008,1056,13908,4044,61800,260
VA WD,Carroll,Virginia,51035,-80.74786758,36.74433517,26594,55.64,10463,13107,13487,26380,109,24,26,55,151,1455,4426,16468,4245,12209,1746,8656,1807,44000,200
VA WD,Charlotte,Virginia,51037,-78.682827,36.9774189,11688,24.5,4312,5713,5975,7392,4263,18,4,11,33,801,2092,6779,2016,4947,635,3357,955,43100,144
VA WD,Charlottesville,Virginia,51540,-78.48748398,38.03751373,40341,4034.1,16009,18935,21406,30684,8561,39,935,122,476,2443,4810,28185,4903,16785,776,6794,9215,85600,391
VA WD,Clarke,Virginia,51043,-77.99277496,39.12236977,12101,67.98,4236,5989,6112,10984,1054,14,30,19,82,777,1984,7644,1696,4531,295,3141,1095,104300,335
VA WD,Clifton Forge,Virginia,51560,-79.82698059,37.83194923,4679,1559.67,1930,2094,2585,3967,695,2,8,7,25,266,728,2541,1144,2131,201,1197,733,35200,173
VA WD,Colonial Heights,Virginia,51570,-77.40889359,37.26573372,16064,2008,6363,7510,8554,15502,129,33,354,46,161,900,2603,10071,2490,6592,229,4591,1772,71000,368
VA WD,Covington,Virginia,51580,-79.99406815,37.77824402,6991,1747.75,2998,3262,3729,5953,969,6,51,12,27,406,1008,4035,1542,3269,271,2075,923,38700,197
VA WD,Craig,Virginia,51045,-80.22225952,37.48831177,4372,13.25,1676,2219,2153,4354,8,5,4,1,5,282,725,2751,614,1993,317,1393,283,49500,185
VA WD,Culpeper,Virginia,51047,-77.92578888,38.5057373,27791,72.75,9757,13616,14175,22569,4783,87,292,60,192,2179,5196,16936,3480,10471,714,6562,3195,95200,402
VA WD,Cumberland,Virginia,51049,-78.27803802,37.52015495,7825,26.08,2813,3788,4037,4765,3027,8,13,12,45,550,1500,4562,1213,3170,357,2231,582,50600,222
VA WD,Danville,Virginia,51590,-79.41801071,36.59516716,53056,3120.94,21712,24192,28864,33247,19431,72,262,44,276,3437,8580,31138,9901,23297,1585,12905,8807,47000,195
VA WD,Dickenson,Virginia,51051,-82.3403244,37.13139153,17620,53.23,6457,8635,8985,17519,68,13,14,6,58,1037,3765,10671,2147,7112,655,5258,1199,39300,189
VA WD,Emporia,Virginia,51595,-77.54189301,36.69155121,5306,2653,2031,2484,2822,2849,2420,11,24,2,59,403,905,2881,1117,2178,147,1151,880,52000,225
VA WD,Floyd,Virginia,51063,-80.36532974,36.91697693,12005,31.51,4763,5934,6071,11664,292,16,21,12,59,675,2072,7265,1993,5505,742,4008,755,51000,183
VA WD,Fluvanna,Virginia,51065,-78.27793503,37.85170364,12429,42.86,4518,6127,6302,9522,2846,21,18,22,69,949,2188,7674,1618,5035,517,3607,911,75100,329
VA WD,Franklin,Virginia,51067,-79.91817856,37.00620079,39549,57.9,14655,19534,20015,35142,4231,41,71,64,137,2465,6551,25365,5168,17526,2871,11893,2762,63400,206
VA WD,Franklin City,Virginia,51620,-76.93454742,36.6724968,7864,1966,3006,3550,4314,3637,4199,6,20,2,15,582,1523,4506,1253,3166,160,1616,1390,67900,222
VA WD,Frederick,Virginia,51069,-78.28526306,39.23382187,45723,110.18,16470,22835,22888,44536,832,68,218,69,291,3475,8722,29217,4309,17864,1394,13023,3447,90100,351
VA WD,Galax,Virginia,51640,-80.91596222,36.65513039,6670,833.75,2750,3007,3663,6219,387,8,15,41,65,452,975,3875,1368,2943,193,1879,871,45200,187
VA WD,Giles,Virginia,51071,-80.71651459,37.31395531,16366,45.21,6461,7971,8395,16044,284,8,24,6,57,946,2670,10012,2738,7098,637,5202,1259,46300,198
VA WD,Grayson,Virginia,51077,-81.25407791,36.68538666,16278,36.5,6468,7937,8341,15729,486,13,18,32,75,937,2731,9914,2696,7529,1061,5335,1133,39700,168
VA WD,Greene,Virginia,51079,-78.4730835,38.32779884,10297,65.59,3749,5111,5186,9579,664,13,27,14,53,881,1908,6536,972,4154,405,2879,870,73700,314
VA WD,Halifax,Virginia,51083,-78.88381195,36.79973793,29033,35.58,10728,13976,15057,17504,11393,79,23,34,164,1697,5382,17174,4780,11790,1062,8248,2480,45200,138
VA WD,Harrisonburg,Virginia,51660,-78.87410355,38.42982292,30707,5117.83,10310,14192,16515,27968,2018,37,469,215,481,1486,3303,22724,3194,10900,590,4343,5967,89300,341
VA WD,Henry,Virginia,51089,-79.98403947,36.69583702,56942,149.06,21771,27627,29315,43529,13155,63,110,85,253,3652,9619,36635,7036,23169,1398,16961,4810,51800,239
VA WD,Highland,Virginia,51091,-79.56011963,38.38693237,2635,6.33,1081,1304,1331,2630,3,0,2,0,5,147,415,1563,510,1759,678,878,203,51400,172
VA WD,Lee,Virginia,51105,-82.97780368,36.74080086,24496,56.05,9231,11686,12810,24346,91,26,21,12,119,1521,4831,14311,3833,10263,1032,6992,2239,34400,176
VA WD,Lexington,Virginia,51678,-79.44859695,37.7819252,6959,3479.5,2172,4062,2897,6027,811,22,89,10,62,201,611,5113,1034,2311,139,1192,980,74500,284
VA WD,Louisa,Virginia,51109,-77.99773026,37.94205666,20325,40.9,7427,10038,10287,14970,5233,65,37,20,108,1378,3745,12410,2792,9080,1653,5932,1495,64400,283
VA WD,Lynchburg,Virginia,51680,-79.18117142,37.4178257,66049,1320.98,25143,29746,36303,47853,17445,105,501,145,476,4499,10312,40380,10858,27233,2090,14634,10509,56900,272
VA WD,Madison,Virginia,51113,-78.2741394,38.42857933,11949,37.11,4144,5862,6087,10182,1697,29,22,19,35,806,2213,7157,1773,4547,403,3193,951,72200,281
VA WD,Montgomery,Virginia,51121,-80.39812851,37.17249107,73913,189.52,26241,38315,35598,67983,2841,64,2821,204,793,3992,9249,54710,5962,27770,1529,14538,11703,71700,341
VA WD,Nelson,Virginia,51125,-78.91743088,37.78806114,12778,26.96,4807,6252,6526,10246,2406,15,26,85,118,820,2264,7677,2017,7063,2256,3803,1004,53100,206
VA WD,Norton,Virginia,51720,-82.60960007,36.93977928,4247,606.71,1697,1953,2294,3923,269,13,35,7,31,265,845,2541,596,1845,148,1034,663,48000,217
VA WD,Orange,Virginia,51137,-78.03948975,38.25897026,21421,62.63,7930,10395,11026,18233,3079,31,48,30,142,1388,3822,12820,3391,9038,1108,6047,1883,83200,321
VA WD,Page,Virginia,51139,-78.48295212,38.62311172,21690,69.3,8055,10631,11059,21141,442,24,68,15,106,1373,3743,13303,3271,8948,893,6191,1864,61500,243
VA WD,Patrick,Virginia,51141,-80.33120346,36.71165276,17473,36.33,6908,8595,8878,16128,1263,14,19,49,123,949,2924,10769,2831,8125,1217,5629,1279,51700,174
VA WD,Pittsylvania,Virginia,51143,-79.40856171,36.843853,55655,55.93,20613,27297,28358,40570,14919,45,63,58,239,3422,10117,34671,7445,22861,2248,16411,4202,48800,186
VA WD,Pulaski,Virginia,51155,-80.72385025,37.06522369,34496,108.48,13349,16663,17833,32353,2004,42,78,19,154,2020,5670,21721,5085,14740,1391,9746,3603,51400,228
VA WD,Rappahannock,Virginia,51157,-78.14195251,38.69334602,6622,24.8,2496,3313,3309,6095,491,10,14,12,67,453,1067,4242,860,2964,468,1802,694,89300,345
VA WD,Roanoke,Virginia,51161,-80.05339813,37.26431847,79332,316.06,30355,37476,41856,76520,2021,74,645,72,440,4310,13517,50799,10706,31689,1334,23469,6886,80500,369
VA WD,Roanoke City,Virginia,51770,-79.95247269,37.272192,96397,2241.79,41030,44590,51807,71907,23395,165,717,213,665,6835,14339,58777,16446,44384,3354,23234,17796,54000,278
VA WD,Rockbridge,Virginia,51163,-79.41263962,37.81181717,18350,30.43,7202,9156,9194,17678,574,34,48,16,56,1120,3081,11607,2542,7975,773,5394,1808,54700,234
VA WD,Rockingham,Virginia,51165,-78.86080551,38.52680779,57482,66.45,20750,28254,29228,56160,869,49,139,265,546,3923,10126,35812,7621,22614,1864,16217,4533,71800,281
VA WD,Russell,Virginia,51167,-82.08601379,36.92706299,28667,59.85,10641,14045,14622,28310,315,14,15,13,76,1612,5565,17982,3508,11558,917,8534,2107,45000,182
VA WD,Scott,Virginia,51169,-82.64190292,36.74090195,23204,43.37,8966,11214,11990,23030,143,17,4,10,74,1217,3908,14201,3878,10003,1037,6973,1993,41400,171
VA WD,Shenandoah,Virginia,51171,-78.58446884,38.85580063,31636,61.79,12452,15280,16356,31069,359,30,100,78,292,1932,5074,19350,5280,15160,2708,8903,3549,73600,270
VA WD,Smyth,Virginia,51173,-81.54421234,36.82556152,32370,71.62,12234,15488,16882,31596,660,34,68,12,104,1882,5561,20035,4892,13132,898,9092,3142,42600,196
VA WD,Staunton,Virginia,51790,-79.07735825,38.14936829,24461,2717.89,9432,11531,12930,21181,3081,38,102,59,169,1372,3656,15286,4147,10003,571,5776,3656,62700,284
VA WD,Tazewell,Virginia,51185,-81.56474686,37.1379509,45960,88.38,17309,22147,23813,44454,1196,49,245,16,134,2683,8976,28029,6272,18901,1592,13324,3985,48600,209
VA WD,Warren,Virginia,51187,-78.19631958,38.8991127,26142,120.47,9879,12853,13289,24646,1292,45,72,87,248,2042,4414,16267,3419,11223,1344,7146,2733,85100,328
VA WD,Washington,Virginia,51191,-81.97022247,36.75964165,45887,81.65,17483,22275,23612,45081,682,29,72,23,138,2497,7734,29138,6518,19183,1700,13487,3996,52500,224
VA WD,Wise,Virginia,51195,-82.58609772,37.00282097,39573,97.71,14513,19126,20447,38674,713,36,128,22,113,2406,8065,23915,5187,15927,1414,11081,3432,43500,211
VA WD,Wythe,Virginia,51197,-81.05805969,36.91510201,25466,54.77,9852,12081,13385,24471,880,34,73,8,60,1499,4446,15595,3926,10659,807,7595,2257,48900,213
VT D,Addison,Vermont,50001,-73.08612823,44.02791595,32953,42.63,11410,16419,16534,32506,133,77,193,44,208,2466,6135,20924,3428,14022,2612,8468,2942,93400,384
VT D,Bennington,Vermont,50003,-73.05628967,43.02403069,35845,52.95,13595,17343,18502,35464,116,54,184,27,220,2628,6365,21512,5340,18501,4906,9511,4084,97100,370
VT D,Caledonia,Vermont,50005,-72.13384628,44.46276855,27846,42.77,10368,13620,14226,27607,54,100,70,15,90,2089,5591,16504,3662,13449,3081,7396,2972,72700,278
VT D,Chittenden,Vermont,50007,-73.07421875,44.44181061,131761,244,48439,63932,67829,128897,819,294,1466,285,1179,9567,21249,90309,10636,52095,3656,31177,17262,117500,457
VT D,Essex,Vermont,50009,-71.74032211,44.67872238,6405,9.62,2344,3153,3252,6356,13,18,11,7,30,442,1264,3784,915,4403,2059,1836,508,56500,249
VT D,Franklin,Vermont,50011,-72.88393784,44.81974411,39980,61.6,14326,19711,20269,39201,58,585,99,37,136,3349,8427,23895,4309,17250,2924,10390,3936,81700,330
VT D,Grand Isle,Vermont,50013,-73.28585052,44.78118515,5318,59.75,2018,2673,2645,5268,15,23,11,1,20,420,995,3313,590,4135,2117,1567,451,105100,367
VT D,Lamoille,Vermont,50015,-72.64928818,44.5966568,19735,42.81,7397,9865,9870,19557,27,48,71,32,89,1488,3584,12502,2161,9872,2475,5161,2236,89900,363
VT D,Orange,Vermont,50017,-72.41491318,43.99139023,26149,37.9,9455,13099,13050,25935,46,67,71,30,103,2008,5234,15837,3070,12336,2881,7334,2121,86400,338
VT D,Orleans,Vermont,50019,-72.22916031,44.77351952,24053,34.51,8873,11858,12195,23873,49,56,50,25,92,1746,5080,13977,3250,12997,4124,6536,2337,66500,263
VT D,Rutland,Vermont,50021,-73.06319427,43.56689835,62142,66.68,23690,30116,32026,61639,152,70,214,67,273,4355,10638,38599,8550,31181,7491,16226,7464,94000,376
VT D,Washington,Vermont,50023,-72.58390427,44.25526047,54928,79.61,20948,26930,27998,54334,177,106,236,75,663,3898,10042,34095,6893,25328,4380,14384,6564,89900,343
VT D,Windham,Vermont,50025,-72.72206879,42.99449921,41588,52.84,16264,20294,21294,41012,157,74,259,86,303,3050,7580,25566,5392,25796,9532,10447,5817,97200,383
VT D,Windsor,Vermont,50027,-72.58879089,43.58575821,54055,55.61,21523,26479,27576,53439,135,124,280,77,255,3755,9638,32695,7967,29849,8326,14935,6588,97300,386
WA ED,Adams,Washington,53001,-118.6646156,46.99705887,13603,7.08,4586,6858,6745,9100,31,64,93,4315,4467,1258,3374,7433,1538,5263,677,3004,1582,45900,218
WA ED,Asotin,Washington,53003,-117.1995087,46.22649956,17605,27.72,7003,8377,9228,17136,38,260,107,64,278,1297,3577,9811,2920,7519,516,4594,2409,53900,257
WA ED,Benton,Washington,53005,-119.4088516,46.27664757,112560,65.63,42227,55659,56901,102832,1085,861,2246,5536,8624,9287,24446,67464,11363,44877,2650,26663,15564,66200,283
WA ED,Chelan,Washington,53007,-120.5182724,47.89936447,52250,17.92,20645,25780,26470,48333,80,487,378,2972,4786,4037,9939,30079,8195,25048,4403,12784,7861,71500,306
WA ED,Columbia,Washington,53013,-117.9198685,46.30876541,4024,4.65,1582,1997,2027,3874,1,27,16,106,463,222,777,2256,769,2046,464,1070,512,37400,214
WA ED,Douglas,Washington,53017,-119.6282311,47.68563652,26205,14.42,9687,13188,13017,24341,45,226,163,1430,2721,2054,5515,15458,3178,10640,953,6651,3036,68700,338
WA ED,Ferry,Washington,53019,-118.4794388,48.41799736,6295,2.86,2247,3280,3015,5084,20,1131,24,36,85,486,1499,3643,667,3239,992,1568,679,50100,197
WA ED,Franklin,Washington,53021,-118.8262138,46.46532631,37473,30.15,12196,19210,18263,26917,1310,263,869,8114,11316,3534,9425,20784,3730,13664,1468,7277,4919,56000,234
WA ED,Garfield,Washington,53023,-117.5453415,46.34924698,2248,3.18,922,1102,1146,2222,0,12,7,7,22,117,470,1161,500,1209,287,634,288,36900,191
WA ED,Grant,Washington,53025,-119.5065346,47.29257202,54758,20.59,19745,27700,27058,46976,599,568,641,5974,9427,4795,12387,30595,6981,22809,3064,12757,6988,51600,244
WA ED,Kittitas,Washington,53037,-120.6930656,47.16496658,26725,11.58,10460,13263,13462,25529,151,216,477,352,684,1501,4143,17534,3547,13215,2755,5979,4481,60500,260
WA ED,Klickitat,Washington,53039,-120.7383156,45.82278061,16616,8.84,6210,8366,8250,15383,26,581,128,498,928,1250,3613,9486,2267,7213,1003,4096,2114,52700,249
WA ED,Lincoln,Washington,53043,-118.3999329,47.60317421,8864,3.84,3605,4426,4438,8657,15,134,33,25,83,546,1811,4753,1754,4607,1002,2616,989,41100,198
WA ED,Okanogan,Washington,53047,-119.8565979,48.46872902,33350,6.32,12654,16828,16522,27615,52,3597,166,1920,2779,2536,7051,19131,4632,16629,3975,8439,4215,50300,222
WA ED,Pend Oreille,Washington,53051,-117.3314743,48.52210999,8915,6.37,3395,4426,4489,8640,12,206,25,32,120,660,1963,5050,1242,5404,2009,2500,895,49500,237
WA ED,Spokane,Washington,53063,-117.4317131,47.65189743,361364,205.09,141619,175780,185584,341874,5105,5539,6569,2277,6994,26730,68556,218100,47978,150105,8486,90233,51386,59000,288
WA ED,Stevens,Washington,53065,-117.9090042,48.3950634,30948,12.53,11241,15454,15494,28747,65,1807,179,150,483,2271,7486,17336,3855,14601,3360,8566,2675,55900,231
WA ED,Walla Walla,Washington,53071,-118.5103912,46.30076027,48439,38.41,17623,24389,24050,43290,720,359,625,3445,4703,3298,8722,28805,7614,19029,1406,10980,6643,56500,259
WA ED,Whitman,Washington,53075,-117.6397781,46.83846092,38775,18.03,13546,20049,18726,35653,490,248,2112,272,683,1949,4942,28214,3670,14598,1052,6533,7013,61900,303
WA ED,Yakima,Washington,53077,-120.6942635,46.56146049,188823,44.05,65985,93785,95038,139514,1938,8405,1922,37044,45114,16478,40760,107080,24505,70852,4867,41682,24303,55200,270
WA WD,Clallam,Washington,53009,-123.8258667,48.12185097,56464,32.21,22837,28084,28380,52509,321,2695,614,325,1150,3593,10096,31247,11528,25225,2388,16031,6806,79200,308
WA WD,Clark,Washington,53011,-122.5152588,45.80020332,238053,379.67,88440,117501,120552,225192,2976,2296,5670,1919,5872,18531,49157,144998,25367,92849,4409,56872,31568,74200,378
WA WD,Cowlitz,Washington,53015,-122.7302475,46.11588287,82119,72.03,31640,40547,41572,78516,288,1347,1137,831,1672,6092,16316,48619,11092,33304,1664,20705,10935,61300,296
WA WD,Grays Harbor,Washington,53027,-123.7541275,47.15859222,64175,33.46,25514,31943,32232,60230,119,2682,712,432,1173,4691,12613,36656,10215,29932,4418,17088,8426,49100,253
WA WD,Island,Washington,53029,-122.6313571,48.1548481,60195,283.94,21787,31340,28855,55034,1454,480,2553,674,2006,4900,10554,36453,8288,25860,4073,14288,7499,103400,397
WA WD,Jefferson,Washington,53031,-123.6288414,47.82855988,20146,11.16,8627,9949,10197,19252,84,566,195,49,241,1139,3414,11424,4169,11014,2387,6376,2251,88700,312
WA WD,King,Washington,53033,-121.7421379,47.4301281,1507319,708.33,615792,742676,764643,1278532,76289,17305,118784,16409,44337,104924,236147,999156,167092,647343,31551,362038,253754,140100,457
WA WD,Kitsap,Washington,53035,-122.7487068,47.66745949,189731,482.78,69267,96936,92795,171063,5107,3211,8282,2068,6169,15563,37426,116417,20325,74038,4771,44530,24737,89100,380
WA WD,Lewis,Washington,53041,-122.3672752,46.58354759,59358,24.64,22478,29192,30166,57663,189,641,372,493,1366,4308,12528,33216,9306,25487,3009,15743,6735,57600,276
WA WD,Mason,Washington,53045,-123.1497765,47.34154892,38341,39.9,14565,19782,18559,35769,332,1430,478,332,883,2461,7174,22406,6300,22292,7727,11172,3393,70100,298
WA WD,Pacific,Washington,53049,-123.7296753,46.51679993,18882,20.8,7896,9336,9546,17683,57,519,480,143,433,1209,3340,10266,4067,12404,4508,5677,2219,49300,240
WA WD,Pierce,Washington,53053,-122.10215,47.06480598,586203,349.97,214652,292875,293328,498642,42210,8344,29035,7972,20562,48332,111317,365068,61486,228842,14190,129427,85225,82500,374
WA WD,San Juan,Washington,53055,-123.067646,48.53389931,10035,56.06,4392,4967,5068,9811,23,79,86,36,121,581,1480,5825,2149,6075,1683,3158,1234,166400,384
WA WD,Skagit,Washington,53057,-121.6917419,48.47258377,79555,45.85,30573,39205,40350,74133,280,1712,782,2648,4335,5677,15167,46296,12415,33580,3007,21358,9215,81500,341
WA WD,Skamania,Washington,53059,-121.8812676,45.96608734,8289,4.96,3066,4224,4065,7987,5,198,52,47,172,631,1830,4940,888,3922,856,2255,811,67100,264
WA WD,Snohomish,Washington,53061,-121.6605072,48.03221703,465642,221.95,171713,232194,233448,434536,4767,6422,16467,3450,10656,39390,89762,292346,44144,183942,12229,113775,57938,127200,467
WA WD,Thurston,Washington,53067,-122.7187157,46.94279099,161238,221.79,62150,78576,82662,148221,2864,2498,6101,1554,4873,11439,32005,98960,18834,66464,4314,40226,21924,79700,382
WA WD,Wahkiakum,Washington,53069,-123.3335298,46.26188469,3327,12.75,1321,1655,1672,3218,3,53,15,38,71,200,624,1855,648,1496,175,998,323,62300,221
WA WD,Whatcom,Washington,53073,-121.7392845,48.81923485,127780,60.13,48543,62848,64932,119229,650,4014,2363,1524,3718,8813,23201,79696,16070,55742,7199,31237,17306,90800,361
WI ED,Adams,Wisconsin,55001,-89.80379105,43.94691658,15682,24.2,5972,8334,7348,15001,375,125,56,125,308,856,2448,9344,3034,12418,6446,4859,1113,46500,235
WI ED,Ashland,Wisconsin,55003,-90.61847687,46.31244278,16307,15.56,6255,7975,8332,14749,17,1478,46,17,106,1183,3234,8985,2905,8371,2116,4416,1839,37300,217
WI ED,Barron,Wisconsin,55005,-91.85144424,45.42573166,40750,47.11,15435,20131,20619,40346,40,209,95,60,164,2900,8400,22562,6888,19363,3928,11345,4090,47000,246
WI ED,Bayfield,Wisconsin,55007,-91.1649437,46.55438232,14008,9.58,5515,7092,6916,12707,29,1240,24,8,50,941,2787,7810,2470,10918,5403,4347,1168,44700,206
WI ED,Buffalo,Wisconsin,55011,-91.81042862,44.31633759,13584,19.43,5123,6825,6759,13521,5,22,29,7,42,981,2691,7649,2263,5586,463,3853,1270,43000,202
WI ED,Burnett,Wisconsin,55013,-92.4592247,45.89826393,13084,16,5242,6471,6613,12497,22,532,24,9,43,815,2458,7150,2661,11743,6501,4232,1010,44600,205
WI ED,Chippewa,Wisconsin,55017,-91.29209518,45.07444954,52360,51.48,19077,25830,26530,51854,31,150,276,49,174,3877,10953,30046,7484,21024,1947,14163,4914,46500,248
WI ED,Clark,Wisconsin,55019,-90.61573792,44.72729301,31647,25.98,11209,15868,15779,31437,29,91,38,52,116,2429,7140,16618,5460,12904,1695,8827,2382,36900,194
WI ED,Columbia,Wisconsin,55021,-89.39317322,43.46519089,45088,58.48,16868,22390,22698,44469,243,136,136,104,358,3121,8756,26156,7055,19258,2390,12302,4566,55700,279
WI ED,Crawford,Wisconsin,55023,-90.93857193,43.2087326,15940,28.16,5914,7895,8045,15791,50,26,56,17,67,1161,3460,8637,2682,7315,1401,4389,1525,42900,217
WI ED,Dane,Wisconsin,55025,-89.42273712,43.06972122,367085,304.63,142786,180413,186672,344617,10511,1201,8666,2090,5744,25747,57590,249741,34007,147851,5065,78848,63938,78400,423
WI ED,Douglas,Wisconsin,55031,-91.92141724,46.45679092,41758,32,16374,20287,21471,40454,170,805,266,63,201,2822,7859,24270,6807,20610,4236,11390,4984,38700,237
WI ED,Dunn,Wisconsin,55033,-91.90597916,44.94647217,35909,42.1,12250,17898,18011,34929,172,95,633,80,188,2352,6495,22746,4316,13252,1002,8234,4016,49000,270
WI ED,Eau Claire,Wisconsin,55035,-91.28831482,44.72515488,85183,133.52,31282,40838,44345,82202,238,467,2124,152,437,6031,15064,53494,10594,32741,1459,20162,11120,53500,284
WI ED,Grant,Wisconsin,55043,-90.78602982,42.85864258,49264,43.06,17169,24855,24409,48838,76,76,234,40,160,3390,9786,28824,7264,18450,1281,11928,5241,43600,227
WI ED,Green,Wisconsin,55045,-89.59871292,42.67677307,30339,52.04,11541,14881,15458,30173,23,51,66,26,119,2159,6110,17416,4654,12087,546,8003,3538,53600,273
WI ED,Iowa,Wisconsin,55049,-90.13215256,43.0110054,20150,26.51,7406,10006,10144,20093,7,21,19,10,48,1581,4180,11522,2867,8220,814,5371,2035,45900,235
WI ED,Iron,Wisconsin,55051,-90.23399353,46.28491592,6153,8.19,2602,3037,3116,6121,1,25,2,4,8,310,1001,3342,1500,5243,2641,2061,541,30800,171
WI ED,Jackson,Wisconsin,55053,-90.73720551,44.33381462,16588,16.62,6253,8424,8164,15814,47,674,30,23,145,1164,3338,9246,2840,7627,1374,4547,1706,39600,203
WI ED,Jefferson,Wisconsin,55055,-88.77371216,43.02077675,67783,120.61,24019,33452,34331,66702,189,176,287,429,1160,4685,12887,41384,8827,25719,1700,16964,7055,59800,308
WI ED,Juneau,Wisconsin,55057,-90.04729843,43.94804573,21650,27.97,8265,10689,10961,21307,31,166,78,68,152,1532,4382,11939,3797,11422,3157,6275,1990,40700,224
WI ED,La Crosse,Wisconsin,55063,-91.16849899,43.90582466,97904,214.23,36662,47024,50880,94319,438,340,2667,140,640,6918,17192,61253,12541,38239,1577,23043,13619,58400,290
WI ED,Lafayette,Wisconsin,55065,-90.12995529,42.65878487,16076,25.36,5876,7941,8135,16009,14,21,19,13,37,1197,3495,8896,2488,6313,437,4262,1614,39400,213
WI ED,Lincoln,Wisconsin,55069,-89.73157883,45.33927917,26993,30.47,10159,13369,13624,26712,84,96,78,23,118,1770,5501,15347,4375,13256,3097,7751,2408,43200,222
WI ED,Marathon,Wisconsin,55073,-89.76390839,44.90272713,115400,74.02,41547,56985,58415,112189,89,490,2499,133,470,8570,23883,68336,14611,43774,2227,31054,10493,54800,301
WI ED,Monroe,Wisconsin,55081,-90.6424675,43.94240189,36633,40.52,13144,18392,18241,35983,141,301,143,65,234,2891,7801,20552,5389,14135,991,9571,3573,48600,251
WI ED,Oneida,Wisconsin,55085,-89.54160309,45.68463135,31679,28.03,12666,15576,16103,31320,58,223,56,22,90,1998,5526,18434,5721,25173,12507,9804,2862,52900,258
WI ED,Pepin,Wisconsin,55091,-92.08921976,44.54815674,7107,30.77,2612,3514,3593,7070,2,18,9,8,20,505,1545,3735,1322,2919,307,1996,616,40700,204
WI ED,Pierce,Wisconsin,55093,-92.470047,44.70139503,32765,56.79,11011,16325,16440,32366,82,87,172,58,196,2381,6467,20432,3485,11536,525,7784,3227,65500,331
WI ED,Polk,Wisconsin,55095,-92.52140808,45.4702034,34773,37.84,13056,17301,17472,34348,23,321,50,31,131,2542,7386,19296,5549,18562,5506,10165,2891,53600,254
WI ED,Portage,Wisconsin,55097,-89.52692795,44.46342278,61405,75.81,21306,30680,30725,59972,161,255,786,231,572,4266,11478,39058,6603,22910,1604,14984,6322,58800,309
WI ED,Price,Wisconsin,55099,-90.35760498,45.68209648,15600,12.42,6054,7830,7770,15479,7,77,27,10,59,1031,3102,8429,3038,9052,2998,4822,1232,40900,223
WI ED,Richland,Wisconsin,55103,-90.43095779,43.36330223,17521,29.95,6593,8673,8848,17411,12,34,38,26,59,1234,3526,9701,3060,7325,732,4742,1851,40500,229
WI ED,Rock,Wisconsin,55105,-89.06247711,42.6682148,139510,192.96,52252,67952,71558,130803,6638,369,985,715,1754,10784,27075,84058,17593,54840,2588,35611,16641,52300,303
WI ED,Rusk,Wisconsin,55107,-91.10871887,45.46697044,15079,16.52,5693,7450,7629,14821,31,82,114,31,85,1079,3081,8161,2758,7904,2211,4269,1424,36700,205
WI ED,Sauk,Wisconsin,55111,-89.95630264,43.39841461,46975,56.06,17703,23116,23859,46459,54,288,79,95,207,3507,9265,26793,7410,20439,2736,12805,4898,55600,281
WI ED,Sawyer,Wisconsin,55113,-91.11548996,45.89805984,14181,11.3,5569,7155,7026,11962,18,2167,15,19,101,992,2724,7727,2738,13025,7456,4169,1400,49500,183
WI ED,St. Croix,Wisconsin,55109,-92.46746826,45.03453064,50251,69.5,17638,25075,25176,49895,44,121,148,43,192,4140,10977,30034,5100,18519,881,13212,4426,74400,352
WI ED,Taylor,Wisconsin,55119,-90.48421478,45.20729637,18901,19.39,6692,9531,9370,18807,2,39,44,9,42,1514,4196,10319,2872,7710,1018,5277,1415,43500,220
WI ED,Trempealeau,Wisconsin,55121,-91.37948608,44.28988838,25263,34.32,9495,12590,12673,25160,12,32,46,13,53,1767,4826,14046,4624,10097,602,6933,2562,40900,202
WI ED,Vernon,Wisconsin,55123,-90.78619003,43.57596779,25617,31.7,9725,12586,13031,25509,12,36,42,18,98,1857,5170,13798,4792,10830,1105,7408,2317,43600,196
WI ED,Vilas,Wisconsin,55125,-89.48191071,46.08240509,17707,20.42,7294,8785,8922,16116,9,1534,38,10,61,1051,2884,9721,4051,20225,12931,5779,1515,58900,222
WI ED,Washburn,Wisconsin,55129,-91.79460526,45.89974022,13772,16.9,5456,6853,6919,13585,25,122,33,7,34,901,2716,7528,2627,9829,4373,4162,1294,46900,219
WI ED,Wood,Wisconsin,55141,-90.01813507,44.465065,73605,91.89,27473,35923,37682,72157,90,481,722,155,386,5526,15006,42635,10438,28839,1366,20127,7346,50500,272
WI WD,Brown,Wisconsin,55009,-87.99936676,44.45883751,194594,371.36,72280,94915,99679,186621,1012,3869,2522,570,1525,15109,37542,120936,21007,74740,2460,47423,24857,62600,324
WI WD,Calumet,Wisconsin,55015,-88.22040558,44.06910515,34291,105.19,11772,17063,17228,33910,29,146,173,33,149,2837,7656,20026,3772,12465,693,9258,2514,62100,284
WI WD,Dodge,Wisconsin,55027,-88.70083237,43.41667175,76559,86.31,26853,39160,37399,74700,1142,215,197,305,911,5462,14988,44767,11342,28720,1867,19632,7221,54800,290
WI WD,Door,Wisconsin,55029,-87.34967804,44.98748779,25690,52.22,10066,12608,13082,25387,29,178,47,49,153,1725,4934,14472,4559,18037,7971,7800,2266,66500,269
WI WD,Florence,Wisconsin,55037,-88.36494446,45.86774254,4590,9.44,1755,2322,2268,4562,4,14,4,6,11,302,920,2597,771,3775,2020,1454,301,45400,223
WI WD,Fond Du Lac,Wisconsin,55039,-88.51831055,43.74324989,90083,124.25,32644,43686,46397,88760,257,297,448,321,937,6355,18214,52856,12658,34548,1904,23427,9217,56000,298
WI WD,Forest,Wisconsin,55041,-88.72925186,45.72474098,8776,8.68,3290,4420,4356,7842,127,780,14,13,30,670,1711,4739,1656,7203,3913,2530,760,38400,183
WI WD,Green Lake,Wisconsin,55047,-89.0596962,43.80838776,18651,52.24,7189,9064,9587,18386,21,42,103,99,192,1191,3655,10226,3579,9202,2013,5399,1790,48400,231
WI WD,Kenosha,Wisconsin,55059,-88.0455246,42.57787704,128181,469.53,47029,62740,65441,119187,5295,472,669,2558,5580,10124,24209,77655,16193,51262,4233,32368,14661,65100,347
WI WD,Kewaunee,Wisconsin,55061,-87.56855392,44.50855255,18878,55.04,6756,9485,9393,18766,24,52,23,13,54,1335,3980,10576,2987,7544,788,5460,1296,50000,204
WI WD,Langlade,Wisconsin,55067,-89.02660751,45.25060844,19505,22.34,7563,9481,10024,19291,13,137,22,42,104,1316,3887,10607,3695,10825,3262,5862,1701,37600,227
WI WD,Manitowoc,Wisconsin,55071,-87.77787018,44.11088181,80421,135.39,30112,39352,41069,78730,115,318,1071,187,582,5636,15700,46283,12802,31843,1731,22248,7864,49500,232
WI WD,Marinette,Wisconsin,55075,-88.00179291,45.37835884,40548,29.07,15542,19828,20720,40280,8,150,63,47,156,2782,8116,22506,7144,25650,10108,12033,3509,41400,221
WI WD,Marquette,Wisconsin,55077,-89.37996674,43.81429482,12321,27.08,4831,6110,6211,12174,31,49,18,49,149,721,2304,6783,2513,8035,3204,3893,938,45600,228
WI WD,Menominee,Wisconsin,55078,-88.7290535,44.98789597,3890,10.84,1079,1904,1986,416,0,3469,0,5,55,489,1111,1962,328,1742,663,695,384,48600,103
WI WD,Milwaukee,Wisconsin,55079,-87.93928909,43.01922798,959275,3980.39,373048,454801,504474,718918,195470,6994,15308,22585,44671,75373,170929,582386,130587,390715,17667,194221,178827,65300,363
WI WD,Oconto,Wisconsin,55083,-88.20973969,45.02683258,30226,30.17,11283,15101,15125,29926,18,212,36,34,107,2169,6062,17015,4980,18832,7549,9204,2079,43200,217
WI WD,Outagamie,Wisconsin,55087,-88.45852661,44.41696548,140510,218.86,50527,69382,71128,136043,206,1965,1904,392,987,11455,28465,84935,15655,51923,1396,36507,14020,64400,327
WI WD,Ozaukee,Wisconsin,55089,-87.92238235,43.37047768,72831,309.92,25707,36075,36756,71676,492,127,438,98,517,5323,14362,45086,8060,26482,775,19128,6579,100500,431
WI WD,Racine,Wisconsin,55101,-88.02817154,42.72510529,175034,522.49,63736,84934,90100,152098,16999,521,1004,4412,9034,13635,34986,105323,21090,66945,3209,43555,20181,64200,327
WI WD,Shawano,Wisconsin,55115,-88.72592545,44.81015015,37157,41.42,13775,18455,18702,35251,42,1762,70,32,129,2615,7365,20505,6672,16737,2962,10614,3161,45500,229
WI WD,Sheboygan,Wisconsin,55117,-87.93014526,43.71897888,103877,201.7,38592,51391,52486,100389,430,357,2061,640,1668,7393,20462,60888,15134,40695,2103,27116,11476,59400,290
WI WD,Walworth,Wisconsin,55127,-88.5345726,42.66561317,75000,134.89,27620,36873,38127,72747,454,201,494,1104,2017,4948,13031,46348,10673,36937,9317,18467,9153,69100,342
WI WD,Washington,Wisconsin,55131,-88.22363663,43.37171173,95328,221.69,32977,47493,47835,94465,125,208,337,193,670,7240,19803,58343,9942,34382,1405,24383,8594,83900,390
WI WD,Waukesha,Wisconsin,55133,-88.29745483,43.01977158,304715,550.03,105990,151055,153660,298313,1096,672,2699,1935,5448,21801,61309,191679,29926,110452,4462,81927,24063,96300,480
WI WD,Waupaca,Wisconsin,55135,-88.90603638,44.46232605,46104,61.15,17037,22718,23386,45695,22,125,92,170,406,3212,9171,25568,8153,20141,3104,12961,4076,50000,250
WI WD,Waushara,Wisconsin,55137,-89.23730469,44.11316299,19385,30.87,7616,9603,9782,19094,29,70,43,149,379,1239,3557,10829,3760,12246,4630,6116,1500,45300,221
WI WD,Winnebago,Wisconsin,55139,-88.6415596,44.0700531,140320,312.52,53216,68699,71621,136822,697,685,1728,388,1144,9815,23982,88500,18023,56123,2907,35423,17793,60200,318
WV ND,Barbour,West Virginia,54001,-80.02227402,39.1243515,15699,45.77,5835,7504,8195,15333,148,160,35,23,89,957,3009,9218,2515,6956,1121,4523,1312,35200,177
WV ND,Berkeley,West Virginia,54003,-78.02762604,39.44415474,59253,184.59,22350,29400,29853,56511,2209,89,283,161,399,4399,11060,36823,6971,25385,3035,16313,6037,70600,284
WV ND,Braxton,West Virginia,54007,-80.73852921,38.70594978,12998,25.34,4950,6304,6694,12905,46,17,23,7,37,872,2493,7406,2227,5708,758,3854,1096,39300,175
WV ND,Brooke,West Virginia,54009,-80.60126495,40.28270721,26992,299.91,10131,12935,14057,26673,202,29,60,28,85,1322,4768,16477,4425,10838,707,8017,2114,44100,198
WV ND,Calhoun,West Virginia,54013,-81.13290405,38.83408928,7885,28.16,2978,3868,4017,7836,2,14,30,3,18,502,1637,4503,1243,3446,468,2284,694,33200,145
WV ND,Doddridge,West Virginia,54017,-80.72521591,39.27217865,6994,21.79,2623,3464,3530,6952,2,31,8,1,12,413,1460,3987,1134,3251,628,2161,462,33800,157
WV ND,Gilmer,West Virginia,54021,-80.8317337,38.91586494,7669,22.56,2717,3804,3865,7593,32,8,31,5,24,448,1325,4647,1249,3243,526,1939,778,42100,193
WV ND,Grant,West Virginia,54023,-79.23670578,39.06665421,10428,21.73,3925,5132,5296,10273,106,22,19,8,35,641,2003,6239,1545,4746,821,3197,728,49900,178
WV ND,Hampshire,West Virginia,54027,-78.66222,39.31574249,16498,25.62,6182,8172,8326,16314,112,30,18,24,93,1150,3240,9847,2261,8817,2635,5014,1168,50500,179
WV ND,Hancock,West Virginia,54029,-80.5955162,40.5176487,35233,419.44,13781,16872,18361,34135,901,41,113,43,199,1829,6246,21525,5633,14697,916,10573,3208,45600,221
WV ND,Hardy,West Virginia,54031,-78.81496429,39.00150871,10977,18.76,4286,5408,5569,10744,209,14,5,5,55,710,1908,6675,1684,5573,1287,3524,762,49300,186
WV ND,Harrison,West Virginia,54033,-80.38523865,39.28452873,69371,166.36,27009,32892,36479,68056,975,91,186,63,817,4079,12963,40034,12295,29988,2979,19996,7013,45000,205
WV ND,Jefferson,West Virginia,54037,-77.88068008,39.31504631,35926,171.89,12914,17689,18237,32959,2661,58,140,108,428,2559,6636,22628,4103,14606,1692,9286,3628,84100,294
WV ND,Lewis,West Virginia,54041,-80.51714706,38.94512177,17223,44.28,6615,8379,8844,17086,48,26,52,11,67,1000,3160,10224,2839,7454,839,4618,1997,42200,174
WV ND,Marion,West Virginia,54049,-80.22124863,39.51150894,57249,183.49,22667,26694,30555,55076,1859,123,149,42,311,3084,9883,33827,10455,25491,2824,17123,5544,42300,201
WV ND,Marshall,West Virginia,54051,-80.69768906,39.87717438,37356,122.48,14051,18125,19231,37002,204,33,87,30,229,2232,6895,22540,5689,15630,1579,10941,3110,42700,182
WV ND,Mineral,West Virginia,54057,-78.87017363,39.44261551,26697,81.15,9981,12930,13767,25866,735,12,70,14,101,1693,4997,16089,3918,10930,949,7736,2245,49300,196
WV ND,Monongalia,West Virginia,54061,-80.09732056,39.58232689,75509,208.01,29087,37473,38036,71770,1836,125,1598,180,637,4089,10954,52223,8243,31563,2476,18061,11026,64600,297
WV ND,Morgan,West Virginia,54065,-78.25411987,39.54278183,12128,52.73,4731,5890,6238,11985,92,25,18,8,50,679,2090,7320,2039,6757,2026,3927,804,61900,217
WV ND,Ohio,West Virginia,54069,-80.63180161,40.1084156,50871,479.92,20646,23648,27223,48791,1684,31,330,35,146,2972,8190,30091,9618,23229,2583,13770,6876,48800,209
WV ND,Pendleton,West Virginia,54071,-79.34971619,38.68062592,8054,11.54,3061,4018,4036,7869,167,1,13,4,27,530,1407,4726,1391,4516,1455,2428,633,51600,190
WV ND,Pleasants,West Virginia,54073,-81.19306946,39.37262344,7546,57.6,2769,3668,3878,7513,17,8,2,6,9,428,1505,4517,1096,3134,365,2204,565,51100,178
WV ND,Pocahontas,West Virginia,54075,-79.99871826,38.38734436,9008,9.56,3628,4487,4521,8920,69,13,3,3,31,541,1550,5219,1698,5579,1951,2879,749,42000,177
WV ND,Preston,West Virginia,54077,-79.69556808,39.4595089,29037,44.6,10619,14318,14719,28896,73,27,31,10,77,1853,6034,17077,4073,12137,1518,8638,1981,44200,176
WV ND,Randolph,West Virginia,54083,-79.81456375,38.75179863,27803,26.73,10366,13728,14075,27444,223,37,74,25,144,1656,5059,16700,4388,12548,2182,7720,2646,46000,202
WV ND,Ritchie,West Virginia,54085,-81.06950378,39.20310974,10233,22.54,3928,4969,5264,10211,7,4,10,1,7,578,1924,5958,1773,4936,1008,3142,786,32400,147
WV ND,Taylor,West Virginia,54091,-80.05724716,39.34238052,15144,87.03,5741,7326,7818,14993,96,18,32,5,64,978,2865,8853,2448,6528,787,4376,1365,34200,159
WV ND,Tucker,West Virginia,54093,-79.57023621,39.11423302,7728,18.36,3017,3753,3975,7703,4,6,13,2,16,429,1431,4575,1293,3900,883,2425,592,38200,168
WV ND,Tyler,West Virginia,54095,-80.86916733,39.45422935,9796,37.97,3709,4805,4991,9757,4,16,14,5,22,605,1893,5789,1509,4441,732,3043,666,43200,171
WV ND,Upshur,West Virginia,54097,-80.23270798,38.90070343,22867,64.41,8245,11176,11691,22631,121,42,56,17,112,1403,4402,13696,3366,9506,1261,6226,2019,47900,200
WV ND,Webster,West Virginia,54101,-80.43217468,38.48519135,10729,19.3,3996,5204,5525,10704,3,8,8,6,29,685,2249,6133,1662,5072,1076,3131,865,29700,144
WV ND,Wetzel,West Virginia,54103,-80.66830826,39.5753479,19258,53.64,7303,9253,10005,19184,16,12,39,7,37,1202,3755,11445,2856,8129,826,5643,1660,50200,183
WV SD,Boone,West Virginia,54005,-81.7150116,37.99802971,25870,51.43,9656,12573,13297,25590,214,29,19,18,48,1476,5530,15613,3251,10705,1049,7366,2290,41800,196
WV SD,Cabell,West Virginia,54011,-82.27145767,38.4111824,96827,343.36,39146,45329,51498,92103,3966,112,534,112,442,5303,15868,59809,15847,43596,4450,25309,13837,52800,241
WV SD,Clay,West Virginia,54015,-81.05374908,38.46632385,9983,28.85,3627,4918,5065,9968,1,7,6,1,14,700,2283,5718,1282,4359,732,2758,869,33000,140
WV SD,Fayette,West Virginia,54019,-81.06652451,38.04389954,47952,71.89,18292,22990,24962,44697,3017,62,142,34,252,2491,9595,27677,8189,20841,2549,13974,4318,34500,180
WV SD,Greenbrier,West Virginia,54025,-80.42388535,37.97523117,34693,33.85,13775,16619,18074,33296,1277,42,63,15,137,1959,6311,20556,5867,16757,2982,10420,3355,44000,192
WV SD,Jackson,West Virginia,54035,-81.71050262,38.82537842,25938,55.9,9645,12694,13244,25817,16,40,57,8,65,1677,5086,15695,3480,10571,926,7559,2086,51400,226
WV SD,Kanawha,West Virginia,54039,-81.55689621,38.29615402,207619,230.43,84713,97911,109708,192019,13792,242,1306,260,897,12203,36047,126807,32562,92747,8034,58022,26691,56400,259
WV SD,Lincoln,West Virginia,54043,-82.04361343,38.1638279,21382,48.71,7647,10505,10877,21337,6,16,19,4,48,1286,4693,12727,2676,8429,782,5896,1751,38200,172
WV SD,Logan,West Virginia,54045,-81.90174866,37.82891655,43032,94.37,15425,20732,22300,41377,1366,52,187,50,281,2434,9535,25641,5422,16848,1423,11287,4138,42100,196
WV SD,Mason,West Virginia,54053,-81.99982071,38.74554062,25178,58.15,9603,12236,12942,24948,112,26,81,11,53,1472,5048,15098,3560,10932,1329,7534,2069,44800,177
WV SD,McDowell,West Virginia,54047,-81.64679718,37.37635612,35233,65.86,12880,16584,18649,30407,4754,35,26,11,182,2171,8017,19838,5207,15330,2450,10136,2744,15800,139
WV SD,Mercer,West Virginia,54055,-81.1037941,37.41851044,64980,154.71,25390,30447,34533,60420,4133,88,306,33,269,3526,12082,38588,10784,28426,3036,19369,6021,44600,212
WV SD,Mingo,West Virginia,54059,-82.10928726,37.74209023,33739,79.57,11830,16470,17269,32811,823,21,70,14,124,2215,8051,19970,3503,13087,1257,8610,3220,39400,193
WV SD,Monroe,West Virginia,54063,-80.54004288,37.54716873,12406,26.23,4749,6018,6388,12210,159,25,9,3,41,739,2308,7259,2100,5994,1245,4002,747,42500,151
WV SD,Nicholas,West Virginia,54067,-80.83728409,38.32127953,26775,41.19,9970,13114,13661,26670,4,32,51,18,57,1733,5619,15693,3730,11235,1265,8093,1877,42300,186
WV SD,Putnam,West Virginia,54079,-81.88142395,38.47916031,42835,123.8,15695,20973,21862,42499,127,50,144,15,145,2902,8560,26658,4715,16884,1189,13067,2628,62700,265
WV SD,Raleigh,West Virginia,54081,-81.2192421,37.74841118,76819,126.35,29483,36194,40625,70354,5883,101,412,69,320,4358,15700,45004,11757,33278,3795,22268,7215,44100,218
WV SD,Roane,West Virginia,54087,-81.31647873,38.73531151,15120,31.24,5740,7446,7674,15056,4,25,30,5,37,862,3195,8719,2344,6611,871,4478,1262,36600,173
WV SD,Summers,West Virginia,54089,-80.86902237,37.65265274,14204,40.24,5240,6396,7808,13344,728,38,34,60,211,736,2585,8397,2486,6769,1529,4019,1221,34800,166
WV SD,Wayne,West Virginia,54099,-82.41878128,38.13245392,41636,81.96,15626,20107,21529,41489,19,73,48,7,114,2399,8290,25229,5718,16991,1365,11973,3653,46700,213
WV SD,Wirt,West Virginia,54105,-81.37635803,39.03897476,5192,22.09,1942,2543,2649,5184,4,0,4,0,3,337,1047,3063,745,2795,853,1579,363,36300,149
WV SD,Wood,West Virginia,54107,-81.50164413,39.22042847,86915,236.83,34168,41346,45569,85569,793,131,335,87,254,5476,15869,52697,12873,37620,3452,25200,8968,49500,249
WV SD,Wyoming,West Virginia,54109,-81.53688431,37.60516739,28990,57.75,10474,14103,14887,28673,234,40,26,17,88,1686,6608,17536,3160,11756,1282,8427,2047,34300,164
WY D,Albany,Wyoming,56001,-105.8021088,41.71557999,30797,7.22,11957,15928,14869,28829,253,235,643,837,1988,1934,4665,21840,2358,13844,1887,5878,6079,67300,296
WY D,Big Horn,Wyoming,56003,-107.8834305,44.5792675,10525,3.35,3905,5250,5275,10209,2,58,24,232,551,797,2380,5511,1837,5048,1143,2884,1021,44300,204
WY D,Campbell,Wyoming,56005,-105.5492249,44.24740601,29370,6.12,9968,14939,14431,28652,37,323,89,269,882,2642,7834,17800,1094,11538,1570,7023,2945,68500,299
WY D,Carbon,Wyoming,56007,-107.0035362,41.7195015,16659,2.11,6001,8756,7903,15114,100,133,87,1225,2315,1161,3799,9982,1717,8190,2189,4149,1852,52700,231
WY D,Converse,Wyoming,56009,-105.4909554,42.89635849,11128,2.61,4046,5447,5681,10716,15,101,33,263,565,891,2780,6462,995,5234,1188,2872,1174,51000,229
WY D,Crook,Wyoming,56011,-104.5725822,44.5914669,5294,1.85,1892,2641,2653,5258,1,27,3,5,26,428,1271,2952,643,2605,713,1481,411,54400,231
WY D,Fremont,Wyoming,56013,-108.7783241,43.13356972,33662,3.67,12002,16729,16933,26766,51,6222,110,513,1336,2645,7909,19235,3873,14437,2435,8356,3646,50600,236
WY D,Goshen,Wyoming,56015,-104.3548088,42.08947563,12373,5.66,4790,5990,6383,11750,25,99,16,483,1078,844,2655,6876,1998,5551,761,3356,1434,52100,216
WY D,Hot Springs,Wyoming,56017,-108.452816,43.77286339,4809,2.4,1943,2367,2442,4660,14,103,2,30,67,249,1006,2654,900,2429,486,1303,640,53400,219
WY D,Johnson,Wyoming,56019,-106.6908608,44.02597809,6145,1.48,2397,3017,3128,6057,1,61,7,19,78,409,1237,3426,1073,3112,715,1670,727,56600,242
WY D,Laramie,Wyoming,56021,-104.6658821,41.3253479,73142,27.25,28092,36415,36727,66280,2218,528,821,3295,7310,5884,14491,45214,7553,30507,2415,18406,9686,69800,312
WY D,Lincoln,Wyoming,56023,-110.551506,42.43222618,12625,3.1,4137,6423,6202,12431,10,65,38,81,252,1145,3664,6551,1265,5409,1272,3311,826,60200,248
WY D,Natrona,Wyoming,56025,-106.8075714,42.96970177,61226,11.45,23837,30054,31172,59323,458,404,280,761,2252,4669,13185,36916,6456,29082,5245,16416,7421,53100,252
WY D,Niobrara,Wyoming,56027,-104.4851837,43.05784988,2499,0.93,1032,1151,1348,2449,8,20,3,19,36,156,447,1418,478,1456,424,737,295,33700,175
WY D,Park,Wyoming,56029,-109.8046455,44.40483475,23178,3.34,8757,11382,11796,22580,19,130,106,343,825,1682,4827,13593,3076,10306,1549,5927,2830,65600,266
WY D,Platte,Wyoming,56031,-104.969162,42.13435364,8145,4.03,3179,4029,4116,8057,5,24,10,49,404,586,1764,4519,1276,4026,847,2404,775,52100,223
WY D,Sheridan,Wyoming,56033,-106.9520874,44.77812195,23562,9.31,9426,11569,11993,23095,36,210,100,121,444,1456,4848,13731,3527,11154,1728,6444,2982,58200,245
WY D,Sublette,Wyoming,56035,-109.8381729,42.86407852,4843,0.99,1834,2511,2332,4750,5,70,13,5,57,356,1009,2901,577,2911,1077,1281,553,64400,275
WY D,Sweetwater,Wyoming,56037,-108.7855759,41.63210678,38823,3.75,13616,19604,19219,36564,289,305,254,1411,3470,3135,10085,22818,2785,15444,1828,9552,4064,70900,279
WY D,Teton,Wyoming,56039,-110.5519905,43.94597816,11172,2.79,4568,5833,5339,10989,17,95,49,22,158,881,1828,7740,723,7060,2492,2691,1877,133400,392
WY D,Uinta,Wyoming,56041,-110.5507927,41.2894516,18705,8.97,5885,9510,9195,18278,25,128,66,208,773,1818,5623,10266,998,7246,1361,4248,1637,59300,258
WY D,Washakie,Wyoming,56043,-107.8347244,43.83571243,8388,3.74,3156,4213,4175,7864,14,59,41,410,801,587,1928,4708,1165,3732,576,2265,891,54600,236
WY D,Weston,Wyoming,56045,-104.5704575,43.8415699,6518,2.71,2419,3249,3269,6390,3,79,11,35,83,425,1510,3755,828,3090,671,1890,529,44700,217